,_step,env_step,episode,episode_reward,step,time,env,seed,agent
0,0,0,0,11.533143729141234,0,11.719135522842407,acrobot-swingup,187,ALM
1,12500,25000,25,3.81016429949634,12500,221.53374004364014,acrobot-swingup,187,ALM
2,25000,50000,50,19.500073923674957,25000,444.1606271266937,acrobot-swingup,187,ALM
3,37500,75000,75,32.34149180096461,37500,668.201000213623,acrobot-swingup,187,ALM
4,50000,100000,100,36.318514755455055,50000,888.0506114959717,acrobot-swingup,187,ALM
5,62500,125000,125,1.2082133217069777,62500,1107.3434672355652,acrobot-swingup,187,ALM
6,75000,150000,150,23.61394282184317,75000,1331.58225607872,acrobot-swingup,187,ALM
7,87500,175000,175,7.706993273820393,87500,1549.0791363716125,acrobot-swingup,187,ALM
8,100000,200000,200,13.433885329101036,100000,1769.1059708595276,acrobot-swingup,187,ALM
9,112500,225000,225,1.2765898943567655,112500,1988.7326745986938,acrobot-swingup,187,ALM
10,125000,250000,250,0.5595731870536906,125000,2207.3696205615997,acrobot-swingup,187,ALM
11,137500,275000,275,19.830393238434972,137500,2428.661819934845,acrobot-swingup,187,ALM
12,150000,300000,300,0.00014469630770472247,150000,2648.449439048767,acrobot-swingup,187,ALM
13,162500,325000,325,1.4596625693826737,162500,2865.2315599918365,acrobot-swingup,187,ALM
14,175000,350000,350,2.4751466980238197,175000,3084.810754776001,acrobot-swingup,187,ALM
15,187500,375000,375,0.0091257723839798,187500,3304.0992937088013,acrobot-swingup,187,ALM
16,200000,400000,400,18.617641394500392,200000,3521.163329601288,acrobot-swingup,187,ALM
17,212500,425000,425,0.2810220633817603,212500,3737.985459804535,acrobot-swingup,187,ALM
18,225000,450000,450,0.838079176727345,225000,3971.5654413700104,acrobot-swingup,187,ALM
19,237500,475000,475,19.20193331042633,237500,4191.611586332321,acrobot-swingup,187,ALM
20,250000,500000,500,22.913740875221514,250000,4407.55303311348,acrobot-swingup,187,ALM
21,262500,525000,525,1.7038054532700464,262500,4626.809993028641,acrobot-swingup,187,ALM
22,275000,550000,550,5.299274601803793,275000,4844.999006271362,acrobot-swingup,187,ALM
23,287500,575000,575,10.621452387680671,287500,5062.040182590485,acrobot-swingup,187,ALM
24,300000,600000,600,6.633024579435963,300000,5280.814034938812,acrobot-swingup,187,ALM
25,312500,625000,625,0.1116812348197945,312500,5501.698197841644,acrobot-swingup,187,ALM
26,325000,650000,650,8.90758303642621,325000,5720.462538957596,acrobot-swingup,187,ALM
27,337500,675000,675,3.5377808332391565,337500,5937.651481389999,acrobot-swingup,187,ALM
28,350000,700000,700,0.5959864923122441,350000,6156.2844133377075,acrobot-swingup,187,ALM
29,362500,725000,725,35.80976847786253,362500,6374.7960431575775,acrobot-swingup,187,ALM
30,375000,750000,750,9.576269507515413,375000,6589.593187570572,acrobot-swingup,187,ALM
31,387500,775000,775,10.936616534414213,387500,6805.701204299927,acrobot-swingup,187,ALM
32,400000,800000,800,1.6064660663109904,400000,7025.251657485962,acrobot-swingup,187,ALM
33,412500,825000,825,1.2026694843803392,412500,7243.073128938675,acrobot-swingup,187,ALM
34,425000,850000,850,6.402156330482875,425000,7461.325531721115,acrobot-swingup,187,ALM
35,437500,875000,875,29.374396298465435,437500,7677.827453136444,acrobot-swingup,187,ALM
36,450000,900000,900,0.0007423154789160804,450000,7900.965214729309,acrobot-swingup,187,ALM
37,462500,925000,925,28.725924578993293,462500,8121.276862621307,acrobot-swingup,187,ALM
38,475000,950000,950,8.24984456246812,475000,8341.936419487,acrobot-swingup,187,ALM
39,487500,975000,975,2.0151694694562754,487500,8561.380896806717,acrobot-swingup,187,ALM
0,0,0,0,1.0357290745071417,0,17.201606512069702,acrobot-swingup,537,ALM
1,12500,25000,25,52.23835374958863,12500,248.4986710548401,acrobot-swingup,537,ALM
2,25000,50000,50,41.14198576298611,25000,499.1153783798218,acrobot-swingup,537,ALM
3,37500,75000,75,39.65918193587536,37500,740.1018035411835,acrobot-swingup,537,ALM
4,50000,100000,100,28.648741744431724,50000,982.2817587852478,acrobot-swingup,537,ALM
5,62500,125000,125,26.22591957112433,62500,1230.5906450748444,acrobot-swingup,537,ALM
6,75000,150000,150,50.13355836926971,75000,1467.0426588058472,acrobot-swingup,537,ALM
7,87500,175000,175,1.3514949243001628,87500,1689.2336208820343,acrobot-swingup,537,ALM
8,100000,200000,200,31.515808878230622,100000,1925.3338875770569,acrobot-swingup,537,ALM
9,112500,225000,225,64.001901914534,112500,2177.7838118076324,acrobot-swingup,537,ALM
10,125000,250000,250,5.03524546361006,125000,2423.231976747513,acrobot-swingup,537,ALM
11,137500,275000,275,7.669448565405936,137500,2671.672524213791,acrobot-swingup,537,ALM
12,150000,300000,300,9.171076372782537,150000,2917.3724949359894,acrobot-swingup,537,ALM
13,162500,325000,325,10.141299799109937,162500,3165.0684101581573,acrobot-swingup,537,ALM
14,175000,350000,350,11.04688198681596,175000,3416.16420173645,acrobot-swingup,537,ALM
15,187500,375000,375,0.6871081679295314,187500,3662.2365601062775,acrobot-swingup,537,ALM
16,200000,400000,400,42.775979969911916,200000,3918.640347957611,acrobot-swingup,537,ALM
17,212500,425000,425,0.6536195706234114,212500,4148.638397693634,acrobot-swingup,537,ALM
18,225000,450000,450,15.92484278558715,225000,4367.983212471008,acrobot-swingup,537,ALM
19,237500,475000,475,15.755542749832426,237500,4589.036217927933,acrobot-swingup,537,ALM
20,250000,500000,500,7.681126082161751,250000,4838.873133420944,acrobot-swingup,537,ALM
21,262500,525000,525,0.10665460852387165,262500,5093.432512044907,acrobot-swingup,537,ALM
22,275000,550000,550,0.3273507530920374,275000,5347.04802942276,acrobot-swingup,537,ALM
23,287500,575000,575,6.062453958844323,287500,5595.682657718658,acrobot-swingup,537,ALM
24,300000,600000,600,4.068260975932704,300000,5843.652624607086,acrobot-swingup,537,ALM
25,312500,625000,625,0.03804525962452841,312500,6091.044024467468,acrobot-swingup,537,ALM
26,325000,650000,650,18.46098560092015,325000,6343.124613523483,acrobot-swingup,537,ALM
27,337500,675000,675,2.2647958255125613,337500,6581.728060722351,acrobot-swingup,537,ALM
28,350000,700000,700,0.3218951216444926,350000,6826.682642698288,acrobot-swingup,537,ALM
29,362500,725000,725,22.486575522749796,362500,7051.398549079895,acrobot-swingup,537,ALM
30,375000,750000,750,5.070440485713808,375000,7267.985531568527,acrobot-swingup,537,ALM
31,387500,775000,775,57.45848348904252,387500,7489.709169149399,acrobot-swingup,537,ALM
32,400000,800000,800,8.19986096724517,400000,7736.416884660721,acrobot-swingup,537,ALM
33,412500,825000,825,23.30351892397612,412500,7988.851932525635,acrobot-swingup,537,ALM
34,425000,850000,850,0.9480382902794705,425000,8243.292637825012,acrobot-swingup,537,ALM
35,437500,875000,875,23.83089005943326,437500,8493.486916542053,acrobot-swingup,537,ALM
36,450000,900000,900,46.767348396342804,450000,8739.713676214218,acrobot-swingup,537,ALM
37,462500,925000,925,38.75659106082175,462500,8991.846631526947,acrobot-swingup,537,ALM
38,475000,950000,950,34.61876597991164,475000,9235.92180299759,acrobot-swingup,537,ALM
39,487500,975000,975,100.94443332364794,487500,9479.755794763565,acrobot-swingup,537,ALM
0,0,0,0,0.1460659331690797,0,12.262198686599731,acrobot-swingup,323,ALM
1,12500,25000,25,10.993868265675875,12500,230.65020179748535,acrobot-swingup,323,ALM
2,25000,50000,50,33.175200803097226,25000,460.4886255264282,acrobot-swingup,323,ALM
3,37500,75000,75,71.35753311045839,37500,686.2835874557495,acrobot-swingup,323,ALM
4,50000,100000,100,74.83104021697991,50000,897.694895029068,acrobot-swingup,323,ALM
5,62500,125000,125,91.83692827625143,62500,1120.8750910758972,acrobot-swingup,323,ALM
6,75000,150000,150,23.325910986963496,75000,1351.332729101181,acrobot-swingup,323,ALM
7,87500,175000,175,30.895523081827502,87500,1579.8816902637482,acrobot-swingup,323,ALM
8,100000,200000,200,26.40030307372202,100000,1809.39200425148,acrobot-swingup,323,ALM
9,112500,225000,225,5.232772360995876,112500,2036.0809743404388,acrobot-swingup,323,ALM
10,125000,250000,250,1.9636752778089348,125000,2263.371766090393,acrobot-swingup,323,ALM
11,137500,275000,275,22.80647110210655,137500,2493.557956457138,acrobot-swingup,323,ALM
12,150000,300000,300,0.5985038171218953,150000,2720.391284227371,acrobot-swingup,323,ALM
13,162500,325000,325,9.49237578661663,162500,2951.4332826137543,acrobot-swingup,323,ALM
14,175000,350000,350,12.551241467995363,175000,3184.0382430553436,acrobot-swingup,323,ALM
15,187500,375000,375,6.897731724448134,187500,3415.919188976288,acrobot-swingup,323,ALM
16,200000,400000,400,16.829514319260817,200000,3646.4117228984833,acrobot-swingup,323,ALM
17,212500,425000,425,0.7655508490464754,212500,3889.9185223579407,acrobot-swingup,323,ALM
18,225000,450000,450,5.936148781525313,225000,4115.487783193588,acrobot-swingup,323,ALM
19,237500,475000,475,0.6097570464892634,237500,4329.492611646652,acrobot-swingup,323,ALM
20,250000,500000,500,3.8742467124742404,250000,4552.445017337799,acrobot-swingup,323,ALM
21,262500,525000,525,11.47890544107942,262500,4779.630307674408,acrobot-swingup,323,ALM
22,275000,550000,550,2.4093529850731668,275000,5008.845130205154,acrobot-swingup,323,ALM
23,287500,575000,575,13.457550301331239,287500,5240.7753665447235,acrobot-swingup,323,ALM
24,300000,600000,600,8.216726845219362,300000,5474.797742605209,acrobot-swingup,323,ALM
25,312500,625000,625,2.9788606456077296,312500,5707.792275190353,acrobot-swingup,323,ALM
26,325000,650000,650,0.1520326340129064,325000,5934.462993383408,acrobot-swingup,323,ALM
27,337500,675000,675,13.242666236055246,337500,6161.434413194656,acrobot-swingup,323,ALM
28,350000,700000,700,31.728347321638477,350000,6389.147574186325,acrobot-swingup,323,ALM
29,362500,725000,725,1.00528313047462,362500,6619.352298736572,acrobot-swingup,323,ALM
30,375000,750000,750,7.456445686950069,375000,6851.40084695816,acrobot-swingup,323,ALM
31,387500,775000,775,0.7328880055384632,387500,7080.308132410049,acrobot-swingup,323,ALM
32,400000,800000,800,9.5780713922038,400000,7309.419721841812,acrobot-swingup,323,ALM
33,412500,825000,825,19.286104600522723,412500,7537.366822719574,acrobot-swingup,323,ALM
34,425000,850000,850,5.066393089313295,425000,7769.6227741241455,acrobot-swingup,323,ALM
35,437500,875000,875,8.340766683427292,437500,7998.5787358284,acrobot-swingup,323,ALM
36,450000,900000,900,0.20495449683215822,450000,8220.017391204834,acrobot-swingup,323,ALM
37,462500,925000,925,10.387794939616835,462500,8448.166565179825,acrobot-swingup,323,ALM
38,475000,950000,950,3.9742622879377087,475000,8659.025534629822,acrobot-swingup,323,ALM
39,487500,975000,975,5.747576779235507,487500,8870.81402182579,acrobot-swingup,323,ALM
0,0,0,0,22.14449431932855,0,9.601294755935669,acrobot-swingup,599,ALM
1,12500,25000,25,9.21351141115306,12500,207.31241726875305,acrobot-swingup,599,ALM
2,25000,50000,50,25.549010649993367,25000,415.5682227611542,acrobot-swingup,599,ALM
3,37500,75000,75,8.839673303346363,37500,624.896692276001,acrobot-swingup,599,ALM
4,50000,100000,100,36.08603270987537,50000,834.9965977668762,acrobot-swingup,599,ALM
5,62500,125000,125,25.666394990165667,62500,1044.3109967708588,acrobot-swingup,599,ALM
6,75000,150000,150,31.471128467911182,75000,1253.7075893878937,acrobot-swingup,599,ALM
7,87500,175000,175,64.7011081022332,87500,1462.6673109531403,acrobot-swingup,599,ALM
8,100000,200000,200,26.383911793209638,100000,1671.8549847602844,acrobot-swingup,599,ALM
9,112500,225000,225,28.96924543667589,112500,1881.2425603866577,acrobot-swingup,599,ALM
10,125000,250000,250,30.23745080813792,125000,2090.772707223892,acrobot-swingup,599,ALM
11,137500,275000,275,17.881207090369113,137500,2299.324001312256,acrobot-swingup,599,ALM
12,150000,300000,300,31.522211151092893,150000,2507.473034143448,acrobot-swingup,599,ALM
13,162500,325000,325,98.6698747137539,162500,2715.4153282642365,acrobot-swingup,599,ALM
14,175000,350000,350,0.3493323155670631,175000,2924.1168072223663,acrobot-swingup,599,ALM
15,187500,375000,375,58.58473430221507,187500,3134.0622279644012,acrobot-swingup,599,ALM
16,200000,400000,400,84.00223834733227,200000,3344.877861738205,acrobot-swingup,599,ALM
17,212500,425000,425,34.7029383152193,212500,3554.334773540497,acrobot-swingup,599,ALM
18,225000,450000,450,0.30475022681145614,225000,3764.0290915966034,acrobot-swingup,599,ALM
19,237500,475000,475,17.28804060071974,237500,3978.0321247577667,acrobot-swingup,599,ALM
20,250000,500000,500,8.414280542400974,250000,4188.743901014328,acrobot-swingup,599,ALM
21,262500,525000,525,38.31588675530265,262500,4399.728239297867,acrobot-swingup,599,ALM
22,275000,550000,550,67.36230082483272,275000,4612.210418462753,acrobot-swingup,599,ALM
23,287500,575000,575,0.49265984803172225,287500,4822.898771047592,acrobot-swingup,599,ALM
24,300000,600000,600,40.938776598585704,300000,5032.8824734687805,acrobot-swingup,599,ALM
25,312500,625000,625,3.753176163436353,312500,5243.222407579422,acrobot-swingup,599,ALM
26,325000,650000,650,86.79476782514617,325000,5452.473872184753,acrobot-swingup,599,ALM
27,337500,675000,675,15.049683474127061,337500,5662.914706945419,acrobot-swingup,599,ALM
28,350000,700000,700,48.92391380076754,350000,5878.62721991539,acrobot-swingup,599,ALM
29,362500,725000,725,3.825804940839498,362500,6089.966542005539,acrobot-swingup,599,ALM
30,375000,750000,750,102.38455256961743,375000,6299.617435932159,acrobot-swingup,599,ALM
31,387500,775000,775,73.13392494034731,387500,6510.471848726273,acrobot-swingup,599,ALM
32,400000,800000,800,82.58880867717897,400000,6722.016227722168,acrobot-swingup,599,ALM
33,412500,825000,825,84.52706449902448,412500,6932.463340520859,acrobot-swingup,599,ALM
34,425000,850000,850,25.620867819262873,425000,7142.713023662567,acrobot-swingup,599,ALM
35,437500,875000,875,51.52020303107476,437500,7353.0510149002075,acrobot-swingup,599,ALM
36,450000,900000,900,119.2708820589983,450000,7561.067977666855,acrobot-swingup,599,ALM
37,462500,925000,925,33.88590052702894,462500,7769.422436237335,acrobot-swingup,599,ALM
38,475000,950000,950,35.62326099591926,475000,7976.846189260483,acrobot-swingup,599,ALM
39,487500,975000,975,24.727395172625226,487500,8183.523828268051,acrobot-swingup,599,ALM
0,0,0,0,3.3614083531733145,0,10.898311138153076,acrobot-swingup,781,ALM
1,12500,25000,25,10.8337387184683,12500,211.07429933547974,acrobot-swingup,781,ALM
2,25000,50000,50,35.33775569296584,25000,421.47067737579346,acrobot-swingup,781,ALM
3,37500,75000,75,9.733066556274574,37500,632.347029209137,acrobot-swingup,781,ALM
4,50000,100000,100,0.35333595666347106,50000,842.0214169025421,acrobot-swingup,781,ALM
5,62500,125000,125,21.716244235264693,62500,1051.559302330017,acrobot-swingup,781,ALM
6,75000,150000,150,5.260225297170769,75000,1261.774376630783,acrobot-swingup,781,ALM
7,87500,175000,175,13.55160262029697,87500,1471.5085940361023,acrobot-swingup,781,ALM
8,100000,200000,200,2.2412822730997712,100000,1679.9681506156921,acrobot-swingup,781,ALM
9,112500,225000,225,0.034156984514466575,112500,1889.4739553928375,acrobot-swingup,781,ALM
10,125000,250000,250,20.883990421260826,125000,2098.707460165024,acrobot-swingup,781,ALM
11,137500,275000,275,19.152356041861466,137500,2308.7990159988403,acrobot-swingup,781,ALM
12,150000,300000,300,18.76910554772461,150000,2517.881186246872,acrobot-swingup,781,ALM
13,162500,325000,325,12.057135712674462,162500,2727.1900062561035,acrobot-swingup,781,ALM
14,175000,350000,350,22.391614968417645,175000,2935.8404202461243,acrobot-swingup,781,ALM
15,187500,375000,375,6.793241316920346,187500,3145.276251077652,acrobot-swingup,781,ALM
16,200000,400000,400,14.202424322404923,200000,3355.249251127243,acrobot-swingup,781,ALM
17,212500,425000,425,21.15229674540412,212500,3565.5815665721893,acrobot-swingup,781,ALM
18,225000,450000,450,31.94551843617439,225000,3776.5538458824158,acrobot-swingup,781,ALM
19,237500,475000,475,25.926810688542822,237500,4002.4761295318604,acrobot-swingup,781,ALM
20,250000,500000,500,38.727844803489134,250000,4211.833851337433,acrobot-swingup,781,ALM
21,262500,525000,525,59.25883542598372,262500,4421.258949279785,acrobot-swingup,781,ALM
22,275000,550000,550,24.133528572696047,275000,4630.504445314407,acrobot-swingup,781,ALM
23,287500,575000,575,35.28919642172297,287500,4840.644332170486,acrobot-swingup,781,ALM
24,300000,600000,600,72.93537893164014,300000,5050.255412340164,acrobot-swingup,781,ALM
25,312500,625000,625,101.77408094476532,312500,5260.112590551376,acrobot-swingup,781,ALM
26,325000,650000,650,61.481998079146635,325000,5468.228018283844,acrobot-swingup,781,ALM
27,337500,675000,675,50.91834139263674,337500,5677.106509447098,acrobot-swingup,781,ALM
28,350000,700000,700,49.75874598743132,350000,5884.928941726685,acrobot-swingup,781,ALM
29,362500,725000,725,107.09736890507334,362500,6092.733690261841,acrobot-swingup,781,ALM
30,375000,750000,750,94.3445304949324,375000,6300.161948919296,acrobot-swingup,781,ALM
31,387500,775000,775,39.12227318229867,387500,6507.90486240387,acrobot-swingup,781,ALM
32,400000,800000,800,144.44450044038518,400000,6715.6750111579895,acrobot-swingup,781,ALM
33,412500,825000,825,66.61232710819598,412500,6922.126436948776,acrobot-swingup,781,ALM
34,425000,850000,850,100.62731411957867,425000,7128.407888650894,acrobot-swingup,781,ALM
35,437500,875000,875,37.76074283703837,437500,7334.844244480133,acrobot-swingup,781,ALM
36,450000,900000,900,114.07396343851647,450000,7540.585406303406,acrobot-swingup,781,ALM
37,462500,925000,925,81.19601466961774,462500,7747.446198940277,acrobot-swingup,781,ALM
38,475000,950000,950,117.62244455269206,475000,7968.442002773285,acrobot-swingup,781,ALM
39,487500,975000,975,46.70653799385945,487500,8175.135897159576,acrobot-swingup,781,ALM
0,0,0,0,72.97035089913851,0,13.577883958816528,fish-swim,939,ALM
1,12500,25000,25,66.25781056544926,12500,231.0810670852661,fish-swim,939,ALM
2,25000,50000,50,132.46172054966536,25000,474.6956911087036,fish-swim,939,ALM
3,37500,75000,75,169.43285717263305,37500,727.6319270133972,fish-swim,939,ALM
4,50000,100000,100,98.73650366493047,50000,982.4035868644714,fish-swim,939,ALM
5,62500,125000,125,104.19982228249216,62500,1239.1504735946655,fish-swim,939,ALM
6,75000,150000,150,121.14806052923117,75000,1497.205358505249,fish-swim,939,ALM
7,87500,175000,175,103.11344960441855,87500,1750.7386209964752,fish-swim,939,ALM
8,100000,200000,200,89.44887531242593,100000,2010.9674944877625,fish-swim,939,ALM
9,112500,225000,225,96.94555675353293,112500,2256.9507796764374,fish-swim,939,ALM
10,125000,250000,250,137.6859544745511,125000,2509.249706029892,fish-swim,939,ALM
11,137500,275000,275,151.0497767680587,137500,2740.1733775138855,fish-swim,939,ALM
12,150000,300000,300,179.4507781869193,150000,2962.9811613559723,fish-swim,939,ALM
13,162500,325000,325,189.43983349484947,162500,3193.397804260254,fish-swim,939,ALM
14,175000,350000,350,278.2894385902788,175000,3440.339111804962,fish-swim,939,ALM
15,187500,375000,375,165.30426588199492,187500,3692.7625596523285,fish-swim,939,ALM
16,200000,400000,400,276.5746329318539,200000,3946.103705883026,fish-swim,939,ALM
17,212500,425000,425,186.36785429713547,212500,4199.445102214813,fish-swim,939,ALM
18,225000,450000,450,209.70522353904266,225000,4453.0636920928955,fish-swim,939,ALM
19,237500,475000,475,128.8978893140487,237500,4709.405737876892,fish-swim,939,ALM
20,250000,500000,500,364.3970871034693,250000,4953.477432966232,fish-swim,939,ALM
21,262500,525000,525,149.3898894620927,262500,5199.025496482849,fish-swim,939,ALM
22,275000,550000,550,123.89235711153233,275000,5443.669743537903,fish-swim,939,ALM
23,287500,575000,575,201.09299593659335,287500,5671.290793657303,fish-swim,939,ALM
24,300000,600000,600,380.915249037212,300000,5905.830491065979,fish-swim,939,ALM
25,312500,625000,625,172.1903715272012,312500,6161.703499555588,fish-swim,939,ALM
26,325000,650000,650,274.01842798748487,325000,6414.736732959747,fish-swim,939,ALM
27,337500,675000,675,350.4627456869878,337500,6669.062356472015,fish-swim,939,ALM
28,350000,700000,700,344.6419537755096,350000,6918.099735736847,fish-swim,939,ALM
29,362500,725000,725,413.3251902432301,362500,7167.301983118057,fish-swim,939,ALM
30,375000,750000,750,408.7801430877866,375000,7422.914212703705,fish-swim,939,ALM
31,387500,775000,775,402.9501703761829,387500,7671.924475431442,fish-swim,939,ALM
32,400000,800000,800,547.4686676636766,400000,7932.274614810944,fish-swim,939,ALM
33,412500,825000,825,396.1702547184751,412500,8173.094420909882,fish-swim,939,ALM
34,425000,850000,850,243.59292686456752,425000,8403.130316972733,fish-swim,939,ALM
35,437500,875000,875,681.0031260416413,437500,8642.330670595169,fish-swim,939,ALM
36,450000,900000,900,496.9727456975752,450000,8890.09342956543,fish-swim,939,ALM
37,462500,925000,925,360.5812544093975,462500,9137.534651517868,fish-swim,939,ALM
38,475000,950000,950,422.75871875510836,475000,9380.278861522675,fish-swim,939,ALM
39,487500,975000,975,398.0463084018063,487500,9630.69241809845,fish-swim,939,ALM
0,0,0,0,64.8884915260272,0,18.17852544784546,fish-swim,551,ALM
1,12500,25000,25,96.98061811329953,12500,253.03258776664734,fish-swim,551,ALM
2,25000,50000,50,79.31714458999794,25000,487.24575877189636,fish-swim,551,ALM
3,37500,75000,75,86.9715154492205,37500,740.4063148498535,fish-swim,551,ALM
4,50000,100000,100,77.77884607470666,50000,976.5365633964539,fish-swim,551,ALM
5,62500,125000,125,74.62412167418839,62500,1236.1199476718903,fish-swim,551,ALM
6,75000,150000,150,68.70150068737264,75000,1478.189614057541,fish-swim,551,ALM
7,87500,175000,175,57.64877561123641,87500,1732.2173323631287,fish-swim,551,ALM
8,100000,200000,200,55.76512782118208,100000,1989.253629207611,fish-swim,551,ALM
9,112500,225000,225,55.42494576538886,112500,2213.603958129883,fish-swim,551,ALM
10,125000,250000,250,91.32289573092604,125000,2449.858705997467,fish-swim,551,ALM
11,137500,275000,275,76.22071475723489,137500,2692.5607957839966,fish-swim,551,ALM
12,150000,300000,300,83.92157649425657,150000,2931.413277864456,fish-swim,551,ALM
13,162500,325000,325,81.92808389055492,162500,3159.972110271454,fish-swim,551,ALM
14,175000,350000,350,195.64956601222295,175000,3381.210713624954,fish-swim,551,ALM
15,187500,375000,375,195.08795591607668,187500,3638.9203214645386,fish-swim,551,ALM
16,200000,400000,400,155.69079855654508,200000,3884.1756298542023,fish-swim,551,ALM
17,212500,425000,425,99.73249494686203,212500,4100.02766752243,fish-swim,551,ALM
18,225000,450000,450,229.1798266226915,225000,4353.397757768631,fish-swim,551,ALM
19,237500,475000,475,108.602604150659,237500,4609.7087416648865,fish-swim,551,ALM
20,250000,500000,500,73.49766660865888,250000,4847.929519414902,fish-swim,551,ALM
21,262500,525000,525,80.25689668829484,262500,5075.5884301662445,fish-swim,551,ALM
22,275000,550000,550,130.164848515696,275000,5312.628737449646,fish-swim,551,ALM
23,287500,575000,575,200.21761062334843,287500,5541.057816982269,fish-swim,551,ALM
24,300000,600000,600,157.9562606722077,300000,5760.364481210709,fish-swim,551,ALM
25,312500,625000,625,100.41134788580618,312500,5981.063630819321,fish-swim,551,ALM
26,325000,650000,650,208.1270913127325,325000,6202.845809936523,fish-swim,551,ALM
27,337500,675000,675,243.5924178370508,337500,6418.251756429672,fish-swim,551,ALM
28,350000,700000,700,135.5919310167611,350000,6654.670140981674,fish-swim,551,ALM
29,362500,725000,725,320.8899214925661,362500,6876.685678720474,fish-swim,551,ALM
30,375000,750000,750,389.42904888739093,375000,7117.005460977554,fish-swim,551,ALM
31,387500,775000,775,270.7281324852732,387500,7360.08469748497,fish-swim,551,ALM
32,400000,800000,800,237.36463183413366,400000,7617.048322677612,fish-swim,551,ALM
33,412500,825000,825,353.7949011130253,412500,7859.948818922043,fish-swim,551,ALM
34,425000,850000,850,331.0230742374122,425000,8099.155078411102,fish-swim,551,ALM
35,437500,875000,875,159.948283746305,437500,8342.806849956512,fish-swim,551,ALM
36,450000,900000,900,244.35898516470724,450000,8569.794677495956,fish-swim,551,ALM
37,462500,925000,925,376.8413596133773,462500,8814.17957830429,fish-swim,551,ALM
38,475000,950000,950,318.35310097955204,475000,9046.89658331871,fish-swim,551,ALM
39,487500,975000,975,528.011671547435,487500,9291.470663309097,fish-swim,551,ALM
0,0,0,0,59.83524391508844,0,14.664910554885864,fish-swim,8,ALM
1,12500,25000,25,79.75935179999767,12500,234.36837887763977,fish-swim,8,ALM
2,25000,50000,50,62.79543406655041,25000,467.0070605278015,fish-swim,8,ALM
3,37500,75000,75,135.77928292702936,37500,701.2084410190582,fish-swim,8,ALM
4,50000,100000,100,77.57014600153511,50000,935.9321188926697,fish-swim,8,ALM
5,62500,125000,125,236.34793656758637,62500,1170.9062259197235,fish-swim,8,ALM
6,75000,150000,150,85.4750994750342,75000,1413.2603945732117,fish-swim,8,ALM
7,87500,175000,175,165.40870645317358,87500,1650.4472563266754,fish-swim,8,ALM
8,100000,200000,200,132.35076045499858,100000,1885.671926021576,fish-swim,8,ALM
9,112500,225000,225,175.38328820530805,112500,2119.226734161377,fish-swim,8,ALM
10,125000,250000,250,205.0890157582347,125000,2348.1117775440216,fish-swim,8,ALM
11,137500,275000,275,218.47793374975885,137500,2571.4917562007904,fish-swim,8,ALM
12,150000,300000,300,173.60309799380542,150000,2806.1078686714172,fish-swim,8,ALM
13,162500,325000,325,209.64897251827182,162500,3048.1330642700195,fish-swim,8,ALM
14,175000,350000,350,231.8515214153496,175000,3280.766916513443,fish-swim,8,ALM
15,187500,375000,375,179.6544577831625,187500,3514.5158128738403,fish-swim,8,ALM
16,200000,400000,400,232.5795950950888,200000,3749.1860954761505,fish-swim,8,ALM
17,212500,425000,425,358.5419939882187,212500,3997.070846557617,fish-swim,8,ALM
18,225000,450000,450,138.60705881366442,225000,4230.9293649196625,fish-swim,8,ALM
19,237500,475000,475,174.1798539087978,237500,4469.933936357498,fish-swim,8,ALM
20,250000,500000,500,180.5206250931323,250000,4709.2880647182465,fish-swim,8,ALM
21,262500,525000,525,160.90122197395152,262500,4942.080497980118,fish-swim,8,ALM
22,275000,550000,550,196.134761036274,275000,5162.012278556824,fish-swim,8,ALM
23,287500,575000,575,212.1507701715419,287500,5394.307200431824,fish-swim,8,ALM
24,300000,600000,600,100.2425111898288,300000,5627.149979352951,fish-swim,8,ALM
25,312500,625000,625,123.9194113200577,312500,5862.544522047043,fish-swim,8,ALM
26,325000,650000,650,356.6444583236566,325000,6095.073398590088,fish-swim,8,ALM
27,337500,675000,675,477.81724064978846,337500,6327.090691804886,fish-swim,8,ALM
28,350000,700000,700,393.550906775593,350000,6560.158811330795,fish-swim,8,ALM
29,362500,725000,725,414.30864586032175,362500,6794.159361839294,fish-swim,8,ALM
30,375000,750000,750,669.0610457732555,375000,7026.26721405983,fish-swim,8,ALM
31,387500,775000,775,519.6260835322165,387500,7258.927921056747,fish-swim,8,ALM
32,400000,800000,800,514.2041756903773,400000,7499.511968135834,fish-swim,8,ALM
33,412500,825000,825,527.7419431381271,412500,7727.416074514389,fish-swim,8,ALM
34,425000,850000,850,501.56181373075003,425000,7967.615152835846,fish-swim,8,ALM
35,437500,875000,875,512.9143901504364,437500,8201.179481983185,fish-swim,8,ALM
36,450000,900000,900,615.047686632465,450000,8435.988437891006,fish-swim,8,ALM
37,462500,925000,925,520.9505604815457,462500,8671.130881547928,fish-swim,8,ALM
38,475000,950000,950,522.5419022931758,475000,8904.161957979202,fish-swim,8,ALM
39,487500,975000,975,635.7450674548987,487500,9138.686554670334,fish-swim,8,ALM
0,0,0,0,99.88959515117213,0,13.02015471458435,fish-swim,108,ALM
1,12500,25000,25,67.35872540349244,12500,216.3824634552002,fish-swim,108,ALM
2,25000,50000,50,81.66249906703482,25000,431.01808190345764,fish-swim,108,ALM
3,37500,75000,75,49.99897566793925,37500,648.8523006439209,fish-swim,108,ALM
4,50000,100000,100,106.86800351344206,50000,868.1406786441803,fish-swim,108,ALM
5,62500,125000,125,77.3499391656598,62500,1084.3071134090424,fish-swim,108,ALM
6,75000,150000,150,75.52033400214125,75000,1300.87783741951,fish-swim,108,ALM
7,87500,175000,175,59.00765826066171,87500,1516.8402090072632,fish-swim,108,ALM
8,100000,200000,200,72.97221700684062,100000,1734.2281186580658,fish-swim,108,ALM
9,112500,225000,225,82.32157548856645,112500,1954.8285686969757,fish-swim,108,ALM
10,125000,250000,250,94.91436882485375,125000,2175.3085012435913,fish-swim,108,ALM
11,137500,275000,275,77.70937071318215,137500,2396.29523563385,fish-swim,108,ALM
12,150000,300000,300,153.13226584276666,150000,2617.4910097122192,fish-swim,108,ALM
13,162500,325000,325,68.93218344833944,162500,2837.038515806198,fish-swim,108,ALM
14,175000,350000,350,145.82209154621142,175000,3058.1337645053864,fish-swim,108,ALM
15,187500,375000,375,86.8121151687777,187500,3277.172550678253,fish-swim,108,ALM
16,200000,400000,400,76.2465198487844,200000,3496.1818594932556,fish-swim,108,ALM
17,212500,425000,425,136.09011333174013,212500,3712.442251443863,fish-swim,108,ALM
18,225000,450000,450,173.08028252078935,225000,3938.68741106987,fish-swim,108,ALM
19,237500,475000,475,214.94542584919637,237500,4157.207115411758,fish-swim,108,ALM
20,250000,500000,500,169.9768732822545,250000,4374.7776963710785,fish-swim,108,ALM
21,262500,525000,525,76.65644920903934,262500,4593.67053604126,fish-swim,108,ALM
22,275000,550000,550,324.94489483736425,275000,4811.474334478378,fish-swim,108,ALM
23,287500,575000,575,155.2797021032212,287500,5031.47102189064,fish-swim,108,ALM
24,300000,600000,600,395.5483750069701,300000,5251.469993591309,fish-swim,108,ALM
25,312500,625000,625,446.7872537308669,312500,5470.1469078063965,fish-swim,108,ALM
26,325000,650000,650,167.01895850815737,325000,5685.564252138138,fish-swim,108,ALM
27,337500,675000,675,187.58455203141665,337500,5902.033292531967,fish-swim,108,ALM
28,350000,700000,700,260.09267456698524,350000,6117.515789747238,fish-swim,108,ALM
29,362500,725000,725,218.35964683889353,362500,6335.332999706268,fish-swim,108,ALM
30,375000,750000,750,186.88640360988924,375000,6554.909507274628,fish-swim,108,ALM
31,387500,775000,775,337.6353582698092,387500,6775.132182836533,fish-swim,108,ALM
32,400000,800000,800,282.05534034045814,400000,6994.509763002396,fish-swim,108,ALM
33,412500,825000,825,409.30990842876156,412500,7209.054918766022,fish-swim,108,ALM
34,425000,850000,850,405.00458055018834,425000,7426.2488605976105,fish-swim,108,ALM
35,437500,875000,875,310.8820777463394,437500,7642.94561457634,fish-swim,108,ALM
36,450000,900000,900,593.2826339045454,450000,7866.7242023944855,fish-swim,108,ALM
37,462500,925000,925,503.6872988594511,462500,8083.15237903595,fish-swim,108,ALM
38,475000,950000,950,582.5456412569358,475000,8300.3122985363,fish-swim,108,ALM
39,487500,975000,975,310.87803623406813,487500,8519.171354293823,fish-swim,108,ALM
0,0,0,0,74.59432694349456,0,12.016296625137329,fish-swim,610,ALM
1,12500,25000,25,62.26056588031787,12500,208.69473934173584,fish-swim,610,ALM
2,25000,50000,50,76.40578162279104,25000,417.90193724632263,fish-swim,610,ALM
3,37500,75000,75,148.40650747736296,37500,627.6690950393677,fish-swim,610,ALM
4,50000,100000,100,75.97797270870824,50000,837.2411921024323,fish-swim,610,ALM
5,62500,125000,125,126.33865515881443,62500,1046.3388056755066,fish-swim,610,ALM
6,75000,150000,150,70.53829443927201,75000,1256.2000958919525,fish-swim,610,ALM
7,87500,175000,175,148.0101269682296,87500,1465.5692856311798,fish-swim,610,ALM
8,100000,200000,200,244.63231479384018,100000,1675.6438736915588,fish-swim,610,ALM
9,112500,225000,225,186.26659442991905,112500,1885.1553809642792,fish-swim,610,ALM
10,125000,250000,250,190.56002348032933,125000,2094.795350074768,fish-swim,610,ALM
11,137500,275000,275,160.5338810904183,137500,2304.0354177951813,fish-swim,610,ALM
12,150000,300000,300,133.637370769171,150000,2513.3863463401794,fish-swim,610,ALM
13,162500,325000,325,155.79292946674445,162500,2721.8072412014008,fish-swim,610,ALM
14,175000,350000,350,316.86084396180786,175000,2931.112033843994,fish-swim,610,ALM
15,187500,375000,375,227.654047183701,187500,3140.675117254257,fish-swim,610,ALM
16,200000,400000,400,372.0918131166544,200000,3350.683610200882,fish-swim,610,ALM
17,212500,425000,425,367.981260573108,212500,3560.438850402832,fish-swim,610,ALM
18,225000,450000,450,288.16114447243694,225000,3770.3619170188904,fish-swim,610,ALM
19,237500,475000,475,311.7219024110582,237500,3987.8156747817993,fish-swim,610,ALM
20,250000,500000,500,426.6021401406123,250000,4198.84131360054,fish-swim,610,ALM
21,262500,525000,525,259.10974911680285,262500,4409.139062166214,fish-swim,610,ALM
22,275000,550000,550,246.43322046013336,275000,4619.7093670368195,fish-swim,610,ALM
23,287500,575000,575,344.69929207867096,287500,4829.888137817383,fish-swim,610,ALM
24,300000,600000,600,433.3018222741089,300000,5040.949820995331,fish-swim,610,ALM
25,312500,625000,625,416.25304684942967,312500,5251.529234170914,fish-swim,610,ALM
26,325000,650000,650,475.2739286892115,325000,5461.527480125427,fish-swim,610,ALM
27,337500,675000,675,396.09655526466224,337500,5669.987273454666,fish-swim,610,ALM
28,350000,700000,700,253.8163464275508,350000,5878.652897357941,fish-swim,610,ALM
29,362500,725000,725,602.8904151304737,362500,6087.631196975708,fish-swim,610,ALM
30,375000,750000,750,455.19649291846065,375000,6296.5961220264435,fish-swim,610,ALM
31,387500,775000,775,560.7580570022255,387500,6504.609813213348,fish-swim,610,ALM
32,400000,800000,800,563.6277358928915,400000,6712.674757242203,fish-swim,610,ALM
33,412500,825000,825,582.0201486335086,412500,6920.306211471558,fish-swim,610,ALM
34,425000,850000,850,626.0438962569683,425000,7127.3937747478485,fish-swim,610,ALM
35,437500,875000,875,500.15156438275426,437500,7335.37872838974,fish-swim,610,ALM
36,450000,900000,900,463.7653621621304,450000,7543.335174322128,fish-swim,610,ALM
37,462500,925000,925,568.9199665550486,462500,7751.9688992500305,fish-swim,610,ALM
38,475000,950000,950,500.6865784021537,475000,7964.516538858414,fish-swim,610,ALM
39,487500,975000,975,644.1109572809389,487500,8173.195635795593,fish-swim,610,ALM
0,0,0,0,250.10349971087163,0,14.916248559951782,quadruped-walk,117,ALM
1,12500,25000,25,104.8736366989599,12500,223.5182740688324,quadruped-walk,117,ALM
2,25000,50000,50,157.0563231095561,25000,443.6764280796051,quadruped-walk,117,ALM
3,37500,75000,75,301.8205901310192,37500,664.4427874088287,quadruped-walk,117,ALM
4,50000,100000,100,100.62192414802834,50000,888.5649433135986,quadruped-walk,117,ALM
5,62500,125000,125,117.20985791411609,62500,1115.8363873958588,quadruped-walk,117,ALM
6,75000,150000,150,209.63799013639974,75000,1346.3396360874176,quadruped-walk,117,ALM
7,87500,175000,175,82.59512020089235,87500,1572.7702281475067,quadruped-walk,117,ALM
8,100000,200000,200,130.77018285205446,100000,1801.2032492160797,quadruped-walk,117,ALM
9,112500,225000,225,64.98351114432256,112500,2033.180462360382,quadruped-walk,117,ALM
10,125000,250000,250,183.76087511065134,125000,2269.4504709243774,quadruped-walk,117,ALM
11,137500,275000,275,190.84212732786926,137500,2498.847917318344,quadruped-walk,117,ALM
12,150000,300000,300,218.1504141543807,150000,2726.73294878006,quadruped-walk,117,ALM
13,162500,325000,325,288.67646860068555,162500,2954.692259311676,quadruped-walk,117,ALM
14,175000,350000,350,89.9709092389393,175000,3182.8775086402893,quadruped-walk,117,ALM
15,187500,375000,375,356.71943524035674,187500,3409.210773229599,quadruped-walk,117,ALM
16,200000,400000,400,338.8604460618568,200000,3633.13338971138,quadruped-walk,117,ALM
17,212500,425000,425,270.9728780642316,212500,3857.873607635498,quadruped-walk,117,ALM
18,225000,450000,450,77.43997574425154,225000,4092.841632604599,quadruped-walk,117,ALM
19,237500,475000,475,166.98568289994205,237500,4317.332381725311,quadruped-walk,117,ALM
20,250000,500000,500,471.2418173378818,250000,4547.293999910355,quadruped-walk,117,ALM
21,262500,525000,525,307.11522230266445,262500,4781.825143098831,quadruped-walk,117,ALM
22,275000,550000,550,128.23730641302382,275000,5010.309983968735,quadruped-walk,117,ALM
23,287500,575000,575,230.0347357548933,287500,5243.86558508873,quadruped-walk,117,ALM
24,300000,600000,600,331.9085174109447,300000,5474.74721288681,quadruped-walk,117,ALM
25,312500,625000,625,293.1108277862157,312500,5706.476375579834,quadruped-walk,117,ALM
26,325000,650000,650,501.5951165045791,325000,5940.407819509506,quadruped-walk,117,ALM
27,337500,675000,675,250.5801678541023,337500,6175.503221511841,quadruped-walk,117,ALM
28,350000,700000,700,258.8076759155043,350000,6401.02392911911,quadruped-walk,117,ALM
29,362500,725000,725,274.9918070787932,362500,6627.236963510513,quadruped-walk,117,ALM
30,375000,750000,750,191.25498184314182,375000,6850.758480787277,quadruped-walk,117,ALM
31,387500,775000,775,347.24373406492793,387500,7079.129994153976,quadruped-walk,117,ALM
32,400000,800000,800,154.46909477317215,400000,7311.821368455887,quadruped-walk,117,ALM
33,412500,825000,825,310.66283068076024,412500,7542.014265537262,quadruped-walk,117,ALM
34,425000,850000,850,109.35371709070259,425000,7772.53866648674,quadruped-walk,117,ALM
35,437500,875000,875,199.61458896741038,437500,7999.003426551819,quadruped-walk,117,ALM
36,450000,900000,900,214.99800934406213,450000,8232.377235651016,quadruped-walk,117,ALM
37,462500,925000,925,434.7265085296757,462500,8469.70586514473,quadruped-walk,117,ALM
38,475000,950000,950,124.03651307926846,475000,8718.038111686707,quadruped-walk,117,ALM
39,487500,975000,975,170.04316255562597,487500,8959.66183257103,quadruped-walk,117,ALM
0,0,0,0,154.20763091394554,0,16.788306713104248,quadruped-walk,810,ALM
1,12500,25000,25,21.20326389512875,12500,223.82170510292053,quadruped-walk,810,ALM
2,25000,50000,50,146.16878466420954,25000,446.91303157806396,quadruped-walk,810,ALM
3,37500,75000,75,152.11830781738257,37500,670.1221385002136,quadruped-walk,810,ALM
4,50000,100000,100,197.05900067028233,50000,894.5681068897247,quadruped-walk,810,ALM
5,62500,125000,125,186.53990654410023,62500,1118.1208374500275,quadruped-walk,810,ALM
6,75000,150000,150,155.37703445882326,75000,1341.5988466739655,quadruped-walk,810,ALM
7,87500,175000,175,260.1501834585611,87500,1565.0530920028687,quadruped-walk,810,ALM
8,100000,200000,200,229.09340113175864,100000,1787.9130623340607,quadruped-walk,810,ALM
9,112500,225000,225,309.3438630125758,112500,2011.0429337024689,quadruped-walk,810,ALM
10,125000,250000,250,124.5420434393078,125000,2233.843881368637,quadruped-walk,810,ALM
11,137500,275000,275,161.12781271070074,137500,2457.2716472148895,quadruped-walk,810,ALM
12,150000,300000,300,202.93809122273166,150000,2682.489282846451,quadruped-walk,810,ALM
13,162500,325000,325,229.41151423554123,162500,2912.7222406864166,quadruped-walk,810,ALM
14,175000,350000,350,436.1981580096723,175000,3137.1028077602386,quadruped-walk,810,ALM
15,187500,375000,375,432.8747581354672,187500,3361.187686920166,quadruped-walk,810,ALM
16,200000,400000,400,282.83786342530834,200000,3585.4060547351837,quadruped-walk,810,ALM
17,212500,425000,425,304.44368057647023,212500,3827.6129927635193,quadruped-walk,810,ALM
18,225000,450000,450,260.6831829486231,225000,4053.142322063446,quadruped-walk,810,ALM
19,237500,475000,475,348.2882250592776,237500,4276.680797100067,quadruped-walk,810,ALM
20,250000,500000,500,283.939089692852,250000,4500.446900129318,quadruped-walk,810,ALM
21,262500,525000,525,214.97453542688837,262500,4725.291565656662,quadruped-walk,810,ALM
22,275000,550000,550,155.25118730671952,275000,4950.01505279541,quadruped-walk,810,ALM
23,287500,575000,575,338.79633108256456,287500,5174.355425357819,quadruped-walk,810,ALM
24,300000,600000,600,194.7485724118353,300000,5398.853486537933,quadruped-walk,810,ALM
25,312500,625000,625,132.13356433692795,312500,5623.070071935654,quadruped-walk,810,ALM
26,325000,650000,650,227.5645845841836,325000,5855.0763738155365,quadruped-walk,810,ALM
27,337500,675000,675,196.3305187755225,337500,6079.373206138611,quadruped-walk,810,ALM
28,350000,700000,700,319.34878348383063,350000,6304.694941520691,quadruped-walk,810,ALM
29,362500,725000,725,233.20552984087186,362500,6532.069158792496,quadruped-walk,810,ALM
30,375000,750000,750,315.983345510623,375000,6755.818410873413,quadruped-walk,810,ALM
31,387500,775000,775,410.8424581327272,387500,6980.132990598679,quadruped-walk,810,ALM
32,400000,800000,800,638.8860084867767,400000,7204.117969751358,quadruped-walk,810,ALM
33,412500,825000,825,334.7781946767118,412500,7428.146282196045,quadruped-walk,810,ALM
34,425000,850000,850,512.7322391308844,425000,7651.977400064468,quadruped-walk,810,ALM
35,437500,875000,875,369.9914464190036,437500,7879.4578149318695,quadruped-walk,810,ALM
36,450000,900000,900,375.0565398992595,450000,8108.511311292648,quadruped-walk,810,ALM
37,462500,925000,925,179.5731665267296,462500,8332.857379674911,quadruped-walk,810,ALM
38,475000,950000,950,465.80571291380056,475000,8556.919569253922,quadruped-walk,810,ALM
39,487500,975000,975,320.6355168413192,487500,8786.896747350693,quadruped-walk,810,ALM
0,0,0,0,152.55231147483033,0,17.409860610961914,quadruped-walk,515,ALM
1,12500,25000,25,143.57663036568542,12500,222.75631761550903,quadruped-walk,515,ALM
2,25000,50000,50,159.8415275209658,25000,444.2001030445099,quadruped-walk,515,ALM
3,37500,75000,75,431.63555957387644,37500,666.6270098686218,quadruped-walk,515,ALM
4,50000,100000,100,233.62962036959124,50000,888.5243320465088,quadruped-walk,515,ALM
5,62500,125000,125,150.69891485560117,62500,1110.6047551631927,quadruped-walk,515,ALM
6,75000,150000,150,264.13750823329815,75000,1333.1749324798584,quadruped-walk,515,ALM
7,87500,175000,175,257.15169973730593,87500,1555.0908560752869,quadruped-walk,515,ALM
8,100000,200000,200,193.62707618057337,100000,1778.5940482616425,quadruped-walk,515,ALM
9,112500,225000,225,212.0931413509451,112500,2005.7636260986328,quadruped-walk,515,ALM
10,125000,250000,250,178.51194025953458,125000,2228.6099820137024,quadruped-walk,515,ALM
11,137500,275000,275,166.35583883817097,137500,2451.115658760071,quadruped-walk,515,ALM
12,150000,300000,300,205.315240048354,150000,2673.8919417858124,quadruped-walk,515,ALM
13,162500,325000,325,210.57609005484656,162500,2897.1292839050293,quadruped-walk,515,ALM
14,175000,350000,350,120.41676673805117,175000,3119.6597933769226,quadruped-walk,515,ALM
15,187500,375000,375,138.10455586709392,187500,3343.217087984085,quadruped-walk,515,ALM
16,200000,400000,400,627.6052575870384,200000,3568.238045692444,quadruped-walk,515,ALM
17,212500,425000,425,178.3692129395516,212500,3791.891021490097,quadruped-walk,515,ALM
18,225000,450000,450,370.0424902396146,225000,4021.7752072811127,quadruped-walk,515,ALM
19,237500,475000,475,520.1059966802892,237500,4244.439420938492,quadruped-walk,515,ALM
20,250000,500000,500,713.2816086341711,250000,4466.697594881058,quadruped-walk,515,ALM
21,262500,525000,525,315.25846331101764,262500,4689.546684503555,quadruped-walk,515,ALM
22,275000,550000,550,372.11357009874655,275000,4911.943822383881,quadruped-walk,515,ALM
23,287500,575000,575,698.9708681177658,287500,5134.294193744659,quadruped-walk,515,ALM
24,300000,600000,600,550.7843782566658,300000,5356.543097496033,quadruped-walk,515,ALM
25,312500,625000,625,470.9195651828692,312500,5579.340280532837,quadruped-walk,515,ALM
26,325000,650000,650,480.1247344120704,325000,5803.807141780853,quadruped-walk,515,ALM
27,337500,675000,675,560.6414581497966,337500,6027.3257377147675,quadruped-walk,515,ALM
28,350000,700000,700,650.1363047074012,350000,6250.413396835327,quadruped-walk,515,ALM
29,362500,725000,725,852.9245972571682,362500,6474.138965845108,quadruped-walk,515,ALM
30,375000,750000,750,934.5217762406315,375000,6696.006687402725,quadruped-walk,515,ALM
31,387500,775000,775,759.7731543369791,387500,6918.563728809357,quadruped-walk,515,ALM
32,400000,800000,800,931.6544405325312,400000,7140.916447162628,quadruped-walk,515,ALM
33,412500,825000,825,482.6049145421699,412500,7364.57119178772,quadruped-walk,515,ALM
34,425000,850000,850,916.6228338402638,425000,7588.368465423584,quadruped-walk,515,ALM
35,437500,875000,875,762.1293805972954,437500,7818.72887969017,quadruped-walk,515,ALM
36,450000,900000,900,457.58992852984295,450000,8041.910819530487,quadruped-walk,515,ALM
37,462500,925000,925,922.0665808762542,462500,8264.099106550217,quadruped-walk,515,ALM
38,475000,950000,950,923.2320230848507,475000,8486.034524679184,quadruped-walk,515,ALM
39,487500,975000,975,839.9826904979469,487500,8709.137281894684,quadruped-walk,515,ALM
0,0,0,0,199.61579774258652,0,17.268072366714478,quadruped-walk,458,ALM
1,12500,25000,25,11.170489133930486,12500,222.98934936523438,quadruped-walk,458,ALM
2,25000,50000,50,64.29640021004053,25000,446.5058596134186,quadruped-walk,458,ALM
3,37500,75000,75,58.928939725460964,37500,671.5968692302704,quadruped-walk,458,ALM
4,50000,100000,100,20.00508509482106,50000,896.2258944511414,quadruped-walk,458,ALM
5,62500,125000,125,319.2345688420675,62500,1118.6381151676178,quadruped-walk,458,ALM
6,75000,150000,150,243.4510664590649,75000,1340.4005951881409,quadruped-walk,458,ALM
7,87500,175000,175,197.57472423512144,87500,1560.3550238609314,quadruped-walk,458,ALM
8,100000,200000,200,83.74270732846895,100000,1780.1923186779022,quadruped-walk,458,ALM
9,112500,225000,225,262.0476371712598,112500,2003.3532102108002,quadruped-walk,458,ALM
10,125000,250000,250,129.9953285494789,125000,2228.08110165596,quadruped-walk,458,ALM
11,137500,275000,275,237.1513792634094,137500,2452.278746843338,quadruped-walk,458,ALM
12,150000,300000,300,179.39468440952814,150000,2682.4401915073395,quadruped-walk,458,ALM
13,162500,325000,325,268.8108486852766,162500,2907.283273458481,quadruped-walk,458,ALM
14,175000,350000,350,210.58412060616305,175000,3131.146192550659,quadruped-walk,458,ALM
15,187500,375000,375,246.81381105670624,187500,3356.9674627780914,quadruped-walk,458,ALM
16,200000,400000,400,214.98609025731602,200000,3582.29523563385,quadruped-walk,458,ALM
17,212500,425000,425,207.93760603980172,212500,3808.5748405456543,quadruped-walk,458,ALM
18,225000,450000,450,271.13328555925136,225000,4038.503671646118,quadruped-walk,458,ALM
19,237500,475000,475,304.7786038779888,237500,4261.097331047058,quadruped-walk,458,ALM
20,250000,500000,500,219.36122877487392,250000,4483.243192195892,quadruped-walk,458,ALM
21,262500,525000,525,549.0358234920931,262500,4704.0753881931305,quadruped-walk,458,ALM
22,275000,550000,550,546.0837090071465,275000,4927.046808481216,quadruped-walk,458,ALM
23,287500,575000,575,392.6703955817188,287500,5149.421496391296,quadruped-walk,458,ALM
24,300000,600000,600,362.76993322077664,300000,5372.514123916626,quadruped-walk,458,ALM
25,312500,625000,625,483.19863904145024,312500,5593.50821018219,quadruped-walk,458,ALM
26,325000,650000,650,151.0418208582743,325000,5814.624568462372,quadruped-walk,458,ALM
27,337500,675000,675,346.89203008456934,337500,6037.0940198898315,quadruped-walk,458,ALM
28,350000,700000,700,433.66852453688216,350000,6261.566159725189,quadruped-walk,458,ALM
29,362500,725000,725,309.4504561685168,362500,6480.6813061237335,quadruped-walk,458,ALM
30,375000,750000,750,378.91601150107095,375000,6700.972328424454,quadruped-walk,458,ALM
31,387500,775000,775,246.29596748940452,387500,6921.023176908493,quadruped-walk,458,ALM
32,400000,800000,800,578.2326772493267,400000,7140.572335720062,quadruped-walk,458,ALM
33,412500,825000,825,328.8542295351906,412500,7359.2618572711945,quadruped-walk,458,ALM
34,425000,850000,850,191.34146851761864,425000,7586.141889333725,quadruped-walk,458,ALM
35,437500,875000,875,76.4967569598443,437500,7812.564497470856,quadruped-walk,458,ALM
36,450000,900000,900,542.7707554918645,450000,8032.20646071434,quadruped-walk,458,ALM
37,462500,925000,925,324.7407029952819,462500,8251.682796478271,quadruped-walk,458,ALM
38,475000,950000,950,585.5498738718136,475000,8472.167433261871,quadruped-walk,458,ALM
39,487500,975000,975,382.25852026161436,487500,8689.443130016327,quadruped-walk,458,ALM
0,0,0,0,248.48128897476892,0,15.5764000415802,quadruped-walk,390,ALM
1,12500,25000,25,120.23723665997076,12500,222.1596372127533,quadruped-walk,390,ALM
2,25000,50000,50,91.48409669811721,25000,448.8409402370453,quadruped-walk,390,ALM
3,37500,75000,75,61.20793736391712,37500,674.6538455486298,quadruped-walk,390,ALM
4,50000,100000,100,173.80190413423128,50000,900.2257106304169,quadruped-walk,390,ALM
5,62500,125000,125,58.78018417952669,62500,1123.8678958415985,quadruped-walk,390,ALM
6,75000,150000,150,186.38254517638967,75000,1351.9022874832153,quadruped-walk,390,ALM
7,87500,175000,175,87.25821393909847,87500,1576.6260566711426,quadruped-walk,390,ALM
8,100000,200000,200,208.82307016186027,100000,1802.004013299942,quadruped-walk,390,ALM
9,112500,225000,225,132.4406541873024,112500,2028.7069368362427,quadruped-walk,390,ALM
10,125000,250000,250,181.04002250444213,125000,2254.152949810028,quadruped-walk,390,ALM
11,137500,275000,275,228.5338469713641,137500,2480.625508785248,quadruped-walk,390,ALM
12,150000,300000,300,178.35113817532238,150000,2705.6980018615723,quadruped-walk,390,ALM
13,162500,325000,325,418.8657247543386,162500,2931.9722802639008,quadruped-walk,390,ALM
14,175000,350000,350,510.7655147768786,175000,3158.1641664505005,quadruped-walk,390,ALM
15,187500,375000,375,342.49445774000077,187500,3382.0345804691315,quadruped-walk,390,ALM
16,200000,400000,400,345.51834145943786,200000,3605.67720746994,quadruped-walk,390,ALM
17,212500,425000,425,361.8192029328663,212500,3832.2267396450043,quadruped-walk,390,ALM
18,225000,450000,450,415.18709517269997,225000,4061.7146968841553,quadruped-walk,390,ALM
19,237500,475000,475,484.17014676714354,237500,4289.328983783722,quadruped-walk,390,ALM
20,250000,500000,500,512.3861039930282,250000,4515.664623737335,quadruped-walk,390,ALM
21,262500,525000,525,555.7332885978847,262500,4742.875383138657,quadruped-walk,390,ALM
22,275000,550000,550,538.6262750517899,275000,4968.780355215073,quadruped-walk,390,ALM
23,287500,575000,575,680.8197979437939,287500,5193.099611759186,quadruped-walk,390,ALM
24,300000,600000,600,859.1893951465275,300000,5419.669239997864,quadruped-walk,390,ALM
25,312500,625000,625,790.8304718644689,312500,5647.873633861542,quadruped-walk,390,ALM
26,325000,650000,650,769.8760628063799,325000,5875.314841032028,quadruped-walk,390,ALM
27,337500,675000,675,779.0550483304091,337500,6098.049407243729,quadruped-walk,390,ALM
28,350000,700000,700,849.3794389510285,350000,6324.001440525055,quadruped-walk,390,ALM
29,362500,725000,725,916.9807900718413,362500,6548.923862457275,quadruped-walk,390,ALM
30,375000,750000,750,671.3894996065538,375000,6774.379971027374,quadruped-walk,390,ALM
31,387500,775000,775,824.8149935782076,387500,6997.573526382446,quadruped-walk,390,ALM
32,400000,800000,800,878.6758025271611,400000,7224.298139333725,quadruped-walk,390,ALM
33,412500,825000,825,901.5329493611328,412500,7449.713764667511,quadruped-walk,390,ALM
34,425000,850000,850,822.7281877663729,425000,7674.0584008693695,quadruped-walk,390,ALM
35,437500,875000,875,823.8931876215686,437500,7902.051389932632,quadruped-walk,390,ALM
36,450000,900000,900,886.0239053427406,450000,8128.982971668243,quadruped-walk,390,ALM
37,462500,925000,925,919.7853308162623,462500,8354.463924646378,quadruped-walk,390,ALM
38,475000,950000,950,907.8112120951131,475000,8577.596630334854,quadruped-walk,390,ALM
39,487500,975000,975,930.1044918543008,487500,8805.858553171158,quadruped-walk,390,ALM
0,0,0,0,25.68065047349459,0,13.394330263137817,walker-walk,781,ALM
1,12500,25000,25,48.028904361147625,12500,218.69523453712463,walker-walk,781,ALM
2,25000,50000,50,554.6862145649282,25000,433.1844925880432,walker-walk,781,ALM
3,37500,75000,75,777.86191882347,37500,647.2960216999054,walker-walk,781,ALM
4,50000,100000,100,762.7809585087866,50000,861.2439908981323,walker-walk,781,ALM
5,62500,125000,125,780.7406550112207,62500,1074.3310692310333,walker-walk,781,ALM
6,75000,150000,150,783.4560902534968,75000,1288.6828305721283,walker-walk,781,ALM
7,87500,175000,175,761.4334703517638,87500,1501.799379825592,walker-walk,781,ALM
8,100000,200000,200,731.383709453032,100000,1717.1697118282318,walker-walk,781,ALM
9,112500,225000,225,790.1726639496075,112500,1931.7256360054016,walker-walk,781,ALM
10,125000,250000,250,772.9834645467884,125000,2147.54305934906,walker-walk,781,ALM
11,137500,275000,275,798.892366931969,137500,2361.5881531238556,walker-walk,781,ALM
12,150000,300000,300,755.359333583804,150000,2576.799031972885,walker-walk,781,ALM
13,162500,325000,325,789.4403448567753,162500,2790.120987892151,walker-walk,781,ALM
14,175000,350000,350,787.1986186978318,175000,3004.409899711609,walker-walk,781,ALM
15,187500,375000,375,802.1308962823784,187500,3218.7245836257935,walker-walk,781,ALM
16,200000,400000,400,788.0401474858825,200000,3432.8640909194946,walker-walk,781,ALM
17,212500,425000,425,788.9756428290173,212500,3646.250496864319,walker-walk,781,ALM
18,225000,450000,450,812.5648573319837,225000,3862.248818397522,walker-walk,781,ALM
19,237500,475000,475,830.0299443928928,237500,4086.6365485191345,walker-walk,781,ALM
20,250000,500000,500,835.0406092681831,250000,4300.518616914749,walker-walk,781,ALM
21,262500,525000,525,821.8688438437505,262500,4515.810862541199,walker-walk,781,ALM
22,275000,550000,550,816.534794003327,275000,4730.27295589447,walker-walk,781,ALM
23,287500,575000,575,804.5287357575927,287500,4944.707550764084,walker-walk,781,ALM
24,300000,600000,600,834.1248404132687,300000,5157.426084518433,walker-walk,781,ALM
25,312500,625000,625,836.5372742350091,312500,5370.422768354416,walker-walk,781,ALM
26,325000,650000,650,831.8344811606155,325000,5583.529505729675,walker-walk,781,ALM
27,337500,675000,675,849.632904930623,337500,5796.77206325531,walker-walk,781,ALM
28,350000,700000,700,847.1968884622516,350000,6009.520836114883,walker-walk,781,ALM
29,362500,725000,725,666.9288617296154,362500,6222.168847799301,walker-walk,781,ALM
30,375000,750000,750,760.5898319034525,375000,6434.719538927078,walker-walk,781,ALM
31,387500,775000,775,875.5641779570636,387500,6648.877397537231,walker-walk,781,ALM
32,400000,800000,800,890.3694640407335,400000,6863.485496044159,walker-walk,781,ALM
33,412500,825000,825,929.2456046848032,412500,7078.324961423874,walker-walk,781,ALM
34,425000,850000,850,852.3722722166722,425000,7290.424463033676,walker-walk,781,ALM
35,437500,875000,875,920.2573879157299,437500,7503.039207935333,walker-walk,781,ALM
36,450000,900000,900,924.7529579985654,450000,7715.832142591476,walker-walk,781,ALM
37,462500,925000,925,909.7937038468766,462500,7943.499459028244,walker-walk,781,ALM
38,475000,950000,950,929.4816058739046,475000,8154.840979099274,walker-walk,781,ALM
39,487500,975000,975,911.328654797049,487500,8367.248821496964,walker-walk,781,ALM
0,0,0,0,25.23661212570071,0,15.176491498947144,walker-walk,446,ALM
1,12500,25000,25,62.34311125362136,12500,238.01056385040283,walker-walk,446,ALM
2,25000,50000,50,263.3536298014252,25000,476.67866492271423,walker-walk,446,ALM
3,37500,75000,75,470.3852303029701,37500,713.6463866233826,walker-walk,446,ALM
4,50000,100000,100,391.80758923500525,50000,945.6329412460327,walker-walk,446,ALM
5,62500,125000,125,629.5136511979392,62500,1176.4031674861908,walker-walk,446,ALM
6,75000,150000,150,646.4471181130855,75000,1420.06014418602,walker-walk,446,ALM
7,87500,175000,175,620.6616899164404,87500,1659.143744468689,walker-walk,446,ALM
8,100000,200000,200,699.3879953755857,100000,1898.2575495243073,walker-walk,446,ALM
9,112500,225000,225,719.3100960072303,112500,2138.1853477954865,walker-walk,446,ALM
10,125000,250000,250,702.3876266739791,125000,2375.670706510544,walker-walk,446,ALM
11,137500,275000,275,707.2942897707044,137500,2613.1671390533447,walker-walk,446,ALM
12,150000,300000,300,712.4162938405398,150000,2852.5557475090027,walker-walk,446,ALM
13,162500,325000,325,716.1153886047612,162500,3090.745947599411,walker-walk,446,ALM
14,175000,350000,350,704.2379266993577,175000,3328.0515570640564,walker-walk,446,ALM
15,187500,375000,375,722.0659152258495,187500,3559.1014058589935,walker-walk,446,ALM
16,200000,400000,400,713.8376987038209,200000,3792.9443612098694,walker-walk,446,ALM
17,212500,425000,425,701.8378537643958,212500,4035.645284175873,walker-walk,446,ALM
18,225000,450000,450,705.6180918723411,225000,4277.488503456116,walker-walk,446,ALM
19,237500,475000,475,733.6570691226681,237500,4513.705374479294,walker-walk,446,ALM
20,250000,500000,500,724.6413351639593,250000,4751.456651926041,walker-walk,446,ALM
21,262500,525000,525,736.4446299463619,262500,4986.770856142044,walker-walk,446,ALM
22,275000,550000,550,729.5217495206023,275000,5222.095161437988,walker-walk,446,ALM
23,287500,575000,575,743.8388786354677,287500,5457.691581249237,walker-walk,446,ALM
24,300000,600000,600,751.1614588436167,300000,5693.357455253601,walker-walk,446,ALM
25,312500,625000,625,758.1506174182327,312500,5929.810438156128,walker-walk,446,ALM
26,325000,650000,650,746.4619748126293,325000,6163.232365608215,walker-walk,446,ALM
27,337500,675000,675,747.4586032440798,337500,6400.754458189011,walker-walk,446,ALM
28,350000,700000,700,762.7532861576321,350000,6619.423669099808,walker-walk,446,ALM
29,362500,725000,725,770.4507468594277,362500,6843.575873851776,walker-walk,446,ALM
30,375000,750000,750,758.3045162246815,375000,7081.202668905258,walker-walk,446,ALM
31,387500,775000,775,756.5769093988762,387500,7323.262382030487,walker-walk,446,ALM
32,400000,800000,800,776.6461921395886,400000,7560.551868438721,walker-walk,446,ALM
33,412500,825000,825,766.9442913345395,412500,7800.274908065796,walker-walk,446,ALM
34,425000,850000,850,773.4038421235166,425000,8039.537238836288,walker-walk,446,ALM
35,437500,875000,875,772.5656034559609,437500,8276.805033683777,walker-walk,446,ALM
36,450000,900000,900,766.854136167962,450000,8512.820005893707,walker-walk,446,ALM
37,462500,925000,925,785.9639580206874,462500,8749.126702070236,walker-walk,446,ALM
38,475000,950000,950,773.4748032732084,475000,8984.651477336884,walker-walk,446,ALM
39,487500,975000,975,787.9828151640224,487500,9219.850997924805,walker-walk,446,ALM
0,0,0,0,25.783029460522044,0,15.606756687164307,walker-walk,374,ALM
1,12500,25000,25,34.8798226748459,12500,211.711181640625,walker-walk,374,ALM
2,25000,50000,50,77.1559491227492,25000,422.80486726760864,walker-walk,374,ALM
3,37500,75000,75,773.3261107055604,37500,634.3307764530182,walker-walk,374,ALM
4,50000,100000,100,962.4520934367787,50000,845.8906898498535,walker-walk,374,ALM
5,62500,125000,125,948.1231363858839,62500,1056.2344453334808,walker-walk,374,ALM
6,75000,150000,150,950.656846874764,75000,1267.135409116745,walker-walk,374,ALM
7,87500,175000,175,953.2029979715905,87500,1477.884896993637,walker-walk,374,ALM
8,100000,200000,200,949.8430796677154,100000,1688.813351392746,walker-walk,374,ALM
9,112500,225000,225,913.4023210300714,112500,1908.8598895072937,walker-walk,374,ALM
10,125000,250000,250,930.4035276903375,125000,2120.7225470542908,walker-walk,374,ALM
11,137500,275000,275,947.9367386666745,137500,2332.124881505966,walker-walk,374,ALM
12,150000,300000,300,949.5449060538382,150000,2545.105639696121,walker-walk,374,ALM
13,162500,325000,325,937.9633380832908,162500,2758.2967805862427,walker-walk,374,ALM
14,175000,350000,350,920.5783355041315,175000,2970.2951905727386,walker-walk,374,ALM
15,187500,375000,375,935.2981662285281,187500,3184.5609686374664,walker-walk,374,ALM
16,200000,400000,400,950.1704968020301,200000,3397.0890939235687,walker-walk,374,ALM
17,212500,425000,425,946.9916082561944,212500,3609.260110139847,walker-walk,374,ALM
18,225000,450000,450,952.2161085288726,225000,3821.054924726486,walker-walk,374,ALM
19,237500,475000,475,953.9765863081553,237500,4041.8280737400055,walker-walk,374,ALM
20,250000,500000,500,970.2064153444007,250000,4253.028974056244,walker-walk,374,ALM
21,262500,525000,525,957.6324772505875,262500,4463.496347904205,walker-walk,374,ALM
22,275000,550000,550,957.5285713122196,275000,4674.391010284424,walker-walk,374,ALM
23,287500,575000,575,943.6350174658589,287500,4884.928437709808,walker-walk,374,ALM
24,300000,600000,600,946.376684742083,300000,5095.915035486221,walker-walk,374,ALM
25,312500,625000,625,938.543138002585,312500,5307.008390426636,walker-walk,374,ALM
26,325000,650000,650,953.4321188966242,325000,5518.303313493729,walker-walk,374,ALM
27,337500,675000,675,948.9388835819105,337500,5731.494523048401,walker-walk,374,ALM
28,350000,700000,700,951.3121747293299,350000,5943.146503448486,walker-walk,374,ALM
29,362500,725000,725,918.6319275215203,362500,6154.333228349686,walker-walk,374,ALM
30,375000,750000,750,924.235308302611,375000,6365.526161193848,walker-walk,374,ALM
31,387500,775000,775,920.9979060181297,387500,6576.872378110886,walker-walk,374,ALM
32,400000,800000,800,966.1912155764833,400000,6788.472306013107,walker-walk,374,ALM
33,412500,825000,825,969.4050305791992,412500,6999.149579048157,walker-walk,374,ALM
34,425000,850000,850,959.1816656335328,425000,7210.645217657089,walker-walk,374,ALM
35,437500,875000,875,972.8356373588656,437500,7421.557747364044,walker-walk,374,ALM
36,450000,900000,900,966.5082546266591,450000,7632.856686830521,walker-walk,374,ALM
37,462500,925000,925,971.8396067140877,462500,7850.856993198395,walker-walk,374,ALM
38,475000,950000,950,972.2288181334307,475000,8061.915390968323,walker-walk,374,ALM
39,487500,975000,975,941.8631502046925,487500,8272.486982107162,walker-walk,374,ALM
0,0,0,0,25.59150030182966,0,14.623026132583618,walker-walk,396,ALM
1,12500,25000,25,38.14709742337975,12500,213.90153551101685,walker-walk,396,ALM
2,25000,50000,50,381.4244337271597,25000,426.5071876049042,walker-walk,396,ALM
3,37500,75000,75,742.3152440227585,37500,640.3130209445953,walker-walk,396,ALM
4,50000,100000,100,707.6636277684393,50000,855.0240964889526,walker-walk,396,ALM
5,62500,125000,125,899.4257801224194,62500,1069.1059215068817,walker-walk,396,ALM
6,75000,150000,150,902.9344882863745,75000,1284.4123604297638,walker-walk,396,ALM
7,87500,175000,175,920.4542481227639,87500,1499.2709560394287,walker-walk,396,ALM
8,100000,200000,200,911.3857499583295,100000,1716.6630189418793,walker-walk,396,ALM
9,112500,225000,225,906.5713671847104,112500,1950.1598925590515,walker-walk,396,ALM
10,125000,250000,250,914.223925627946,125000,2173.6183936595917,walker-walk,396,ALM
11,137500,275000,275,911.5968194301913,137500,2398.631932735443,walker-walk,396,ALM
12,150000,300000,300,924.1587243959581,150000,2620.0089349746704,walker-walk,396,ALM
13,162500,325000,325,934.922746639433,162500,2843.762336730957,walker-walk,396,ALM
14,175000,350000,350,954.1136080414137,175000,3058.407787799835,walker-walk,396,ALM
15,187500,375000,375,932.5397477041226,187500,3275.4515540599823,walker-walk,396,ALM
16,200000,400000,400,927.2492586715641,200000,3489.7871503829956,walker-walk,396,ALM
17,212500,425000,425,965.4887982510036,212500,3703.9136521816254,walker-walk,396,ALM
18,225000,450000,450,945.8957866380881,225000,3922.9296391010284,walker-walk,396,ALM
19,237500,475000,475,962.3056622215705,237500,4135.803645372391,walker-walk,396,ALM
20,250000,500000,500,955.7451492398577,250000,4348.117628335953,walker-walk,396,ALM
21,262500,525000,525,956.8283908711862,262500,4561.260083198547,walker-walk,396,ALM
22,275000,550000,550,961.9502648289659,275000,4774.882593870163,walker-walk,396,ALM
23,287500,575000,575,954.6050076535779,287500,4988.801978111267,walker-walk,396,ALM
24,300000,600000,600,931.9492637503283,300000,5202.551527500153,walker-walk,396,ALM
25,312500,625000,625,938.1089444046675,312500,5417.034765481949,walker-walk,396,ALM
26,325000,650000,650,884.9756737741791,325000,5634.535243034363,walker-walk,396,ALM
27,337500,675000,675,933.3067037394055,337500,5849.417370557785,walker-walk,396,ALM
28,350000,700000,700,949.6194050986551,350000,6063.637595176697,walker-walk,396,ALM
29,362500,725000,725,936.7866223731987,362500,6277.981514930725,walker-walk,396,ALM
30,375000,750000,750,938.0105947279441,375000,6491.668563127518,walker-walk,396,ALM
31,387500,775000,775,945.1715737231225,387500,6705.4661774635315,walker-walk,396,ALM
32,400000,800000,800,943.2829929612051,400000,6919.463602542877,walker-walk,396,ALM
33,412500,825000,825,942.1504887857718,412500,7133.764897584915,walker-walk,396,ALM
34,425000,850000,850,940.334709891885,425000,7348.493067264557,walker-walk,396,ALM
35,437500,875000,875,919.3390759978253,437500,7563.453792095184,walker-walk,396,ALM
36,450000,900000,900,923.7385851969617,450000,7776.173172235489,walker-walk,396,ALM
37,462500,925000,925,953.3882841178696,462500,7990.524129867554,walker-walk,396,ALM
38,475000,950000,950,941.6666044291635,475000,8204.255697250366,walker-walk,396,ALM
39,487500,975000,975,941.8513010043016,487500,8417.794513463974,walker-walk,396,ALM
0,0,0,0,26.60782874053124,0,13.121673345565796,walker-walk,183,ALM
1,12500,25000,25,172.71130672481905,12500,210.84895420074463,walker-walk,183,ALM
2,25000,50000,50,562.4610061647447,25000,420.9376084804535,walker-walk,183,ALM
3,37500,75000,75,747.3042328178715,37500,631.1578080654144,walker-walk,183,ALM
4,50000,100000,100,912.6985441493665,50000,840.3675293922424,walker-walk,183,ALM
5,62500,125000,125,910.1637130114553,62500,1052.6596369743347,walker-walk,183,ALM
6,75000,150000,150,937.988716026887,75000,1262.0692780017853,walker-walk,183,ALM
7,87500,175000,175,908.428846890504,87500,1472.786190032959,walker-walk,183,ALM
8,100000,200000,200,869.0764409867128,100000,1683.3121299743652,walker-walk,183,ALM
9,112500,225000,225,864.2446615746794,112500,1894.4117276668549,walker-walk,183,ALM
10,125000,250000,250,914.7886437032079,125000,2104.542456150055,walker-walk,183,ALM
11,137500,275000,275,900.6232960139087,137500,2314.0570335388184,walker-walk,183,ALM
12,150000,300000,300,861.0302295787931,150000,2523.5123920440674,walker-walk,183,ALM
13,162500,325000,325,884.1430934183351,162500,2732.420360803604,walker-walk,183,ALM
14,175000,350000,350,882.9416281931099,175000,2939.709947347641,walker-walk,183,ALM
15,187500,375000,375,875.955257888669,187500,3147.5084269046783,walker-walk,183,ALM
16,200000,400000,400,905.4376113091972,200000,3356.3573603630066,walker-walk,183,ALM
17,212500,425000,425,869.4734752145147,212500,3564.37385225296,walker-walk,183,ALM
18,225000,450000,450,911.2363437321098,225000,3771.5489859580994,walker-walk,183,ALM
19,237500,475000,475,918.5662907184302,237500,3982.9040429592133,walker-walk,183,ALM
20,250000,500000,500,915.184057436047,250000,4190.195497512817,walker-walk,183,ALM
21,262500,525000,525,904.2976329208625,262500,4398.694528341293,walker-walk,183,ALM
22,275000,550000,550,904.7191325289195,275000,4607.034456729889,walker-walk,183,ALM
23,287500,575000,575,923.2741455508583,287500,4815.298261880875,walker-walk,183,ALM
24,300000,600000,600,912.5048142611404,300000,5024.566481351852,walker-walk,183,ALM
25,312500,625000,625,917.6868147559762,312500,5233.663804292679,walker-walk,183,ALM
26,325000,650000,650,893.6354778428533,325000,5441.613573312759,walker-walk,183,ALM
27,337500,675000,675,886.4799339054949,337500,5648.55557346344,walker-walk,183,ALM
28,350000,700000,700,899.9501367485151,350000,5855.835631370544,walker-walk,183,ALM
29,362500,725000,725,901.996485232073,362500,6063.256341934204,walker-walk,183,ALM
30,375000,750000,750,913.8518394637853,375000,6273.910120010376,walker-walk,183,ALM
31,387500,775000,775,915.8338045821243,387500,6484.405837059021,walker-walk,183,ALM
32,400000,800000,800,915.3595619834359,400000,6694.205518245697,walker-walk,183,ALM
33,412500,825000,825,928.8993066767182,412500,6905.031406402588,walker-walk,183,ALM
34,425000,850000,850,950.9193881748012,425000,7115.677487611771,walker-walk,183,ALM
35,437500,875000,875,934.6358755125427,437500,7326.200616121292,walker-walk,183,ALM
36,450000,900000,900,917.8626823800487,450000,7536.9020392894745,walker-walk,183,ALM
37,462500,925000,925,954.7058403226632,462500,7746.436030387878,walker-walk,183,ALM
38,475000,950000,950,946.0814938589995,475000,7959.616241455078,walker-walk,183,ALM
39,487500,975000,975,945.9312003108209,487500,8170.192142963409,walker-walk,183,ALM
0,0,0,0,0.6645644543059298,0,18.764564037322998,humanoid-walk,531,ALM
1,12500,25000,25,1.1670868925878477,12500,237.18483757972717,humanoid-walk,531,ALM
2,25000,50000,50,0.9069046632267108,25000,473.70160460472107,humanoid-walk,531,ALM
3,37500,75000,75,0.820699865987122,37500,710.0258672237396,humanoid-walk,531,ALM
4,50000,100000,100,1.2309855939290193,50000,946.5366358757019,humanoid-walk,531,ALM
5,62500,125000,125,1.1181753612232246,62500,1183.109944343567,humanoid-walk,531,ALM
6,75000,150000,150,1.2613215108167926,75000,1418.5433132648468,humanoid-walk,531,ALM
7,87500,175000,175,1.0575945332369774,87500,1651.0296211242676,humanoid-walk,531,ALM
8,100000,200000,200,0.9431889146271051,100000,1885.5987794399261,humanoid-walk,531,ALM
9,112500,225000,225,1.0370342827393455,112500,2120.4565188884735,humanoid-walk,531,ALM
10,125000,250000,250,1.222429526700689,125000,2355.9012610912323,humanoid-walk,531,ALM
11,137500,275000,275,0.9105478419037889,137500,2590.2554035186768,humanoid-walk,531,ALM
12,150000,300000,300,1.369645306725474,150000,2825.631933927536,humanoid-walk,531,ALM
13,162500,325000,325,0.9668246026873379,162500,3056.8460323810577,humanoid-walk,531,ALM
14,175000,350000,350,1.2769563852721002,175000,3290.616252183914,humanoid-walk,531,ALM
15,187500,375000,375,1.0623683976810716,187500,3521.5583403110504,humanoid-walk,531,ALM
16,200000,400000,400,1.1227999592977327,200000,3752.478494167328,humanoid-walk,531,ALM
17,212500,425000,425,1.286652050626294,212500,3999.7210199832916,humanoid-walk,531,ALM
18,225000,450000,450,0.6570773011352509,225000,4233.744822978973,humanoid-walk,531,ALM
19,237500,475000,475,0.7956091359334729,237500,4466.078623056412,humanoid-walk,531,ALM
20,250000,500000,500,1.2699895056316275,250000,4698.5213804244995,humanoid-walk,531,ALM
21,262500,525000,525,1.1767333710484222,262500,4935.9876227378845,humanoid-walk,531,ALM
22,275000,550000,550,1.5162402884772679,275000,5167.879445075989,humanoid-walk,531,ALM
23,287500,575000,575,1.3446301544118215,287500,5401.473402738571,humanoid-walk,531,ALM
24,300000,600000,600,1.1387780822082352,300000,5631.921404123306,humanoid-walk,531,ALM
25,312500,625000,625,1.133336503325033,312500,5864.29109621048,humanoid-walk,531,ALM
26,325000,650000,650,1.7948867694134407,325000,6097.396266460419,humanoid-walk,531,ALM
27,337500,675000,675,0.9606321285631184,337500,6329.827055454254,humanoid-walk,531,ALM
28,350000,700000,700,1.428162754055997,350000,6561.860643386841,humanoid-walk,531,ALM
29,362500,725000,725,1.3816263329430207,362500,6796.992680311203,humanoid-walk,531,ALM
30,375000,750000,750,1.013739780467968,375000,7031.040817260742,humanoid-walk,531,ALM
31,387500,775000,775,1.1933592575082055,387500,7263.957984209061,humanoid-walk,531,ALM
32,400000,800000,800,1.3642088396814636,400000,7496.411696434021,humanoid-walk,531,ALM
33,412500,825000,825,0.948659877915756,412500,7729.9122977256775,humanoid-walk,531,ALM
34,425000,850000,850,1.2935076094489304,425000,7977.208340167999,humanoid-walk,531,ALM
35,437500,875000,875,0.9514398437592346,437500,8211.410332202911,humanoid-walk,531,ALM
36,450000,900000,900,1.4946338858380361,450000,8443.485041856766,humanoid-walk,531,ALM
37,462500,925000,925,1.2647484907619218,462500,8677.512109518051,humanoid-walk,531,ALM
38,475000,950000,950,1.6747618214637607,475000,8909.740669727325,humanoid-walk,531,ALM
39,487500,975000,975,2.059381832045413,487500,9143.356616020203,humanoid-walk,531,ALM
40,500000,1000000,1000,1.121509878749942,500000,9375.170964717865,humanoid-walk,531,ALM
41,512500,1025000,1025,1.6013046209556947,512500,9607.919469594955,humanoid-walk,531,ALM
42,525000,1050000,1050,0.9073754410879454,525000,9839.805348396301,humanoid-walk,531,ALM
43,537500,1075000,1075,1.3088838740979163,537500,10072.70393037796,humanoid-walk,531,ALM
44,550000,1100000,1100,1.1740588885848697,550000,10304.63776254654,humanoid-walk,531,ALM
45,562500,1125000,1125,1.242131002214083,562500,10537.898241519928,humanoid-walk,531,ALM
46,575000,1150000,1150,0.9963093104174989,575000,10772.831802845001,humanoid-walk,531,ALM
47,587500,1175000,1175,1.0149422013253033,587500,11005.975546836853,humanoid-walk,531,ALM
48,600000,1200000,1200,1.4433530037356248,600000,11238.480706453323,humanoid-walk,531,ALM
49,612500,1225000,1225,1.270659226638619,612500,11473.630422115326,humanoid-walk,531,ALM
50,625000,1250000,1250,0.7702930611421042,625000,11711.154851675034,humanoid-walk,531,ALM
51,637500,1275000,1275,0.8697511895644603,637500,11945.47030711174,humanoid-walk,531,ALM
52,650000,1300000,1300,1.388301532878517,650000,12176.41628074646,humanoid-walk,531,ALM
53,662500,1325000,1325,0.7331652018721824,662500,12410.491553544998,humanoid-walk,531,ALM
54,675000,1350000,1350,1.6619790666315672,675000,12644.250123739243,humanoid-walk,531,ALM
55,687500,1375000,1375,1.3925053105834435,687500,12878.317077159882,humanoid-walk,531,ALM
56,700000,1400000,1400,1.0701427657552327,700000,13118.466985225677,humanoid-walk,531,ALM
57,712500,1425000,1425,1.326662673299451,712500,13350.99046254158,humanoid-walk,531,ALM
58,725000,1450000,1450,1.1557386752012349,725000,13584.209294319153,humanoid-walk,531,ALM
59,737500,1475000,1475,0.8751896775504736,737500,13816.377363681793,humanoid-walk,531,ALM
60,750000,1500000,1500,1.4330280431878364,750000,14048.390641212463,humanoid-walk,531,ALM
61,762500,1525000,1525,1.6228711680492374,762500,14279.977877616882,humanoid-walk,531,ALM
62,775000,1550000,1550,2.080148267945007,775000,14513.522206783295,humanoid-walk,531,ALM
63,787500,1575000,1575,0.9919791879594868,787500,14745.450476169586,humanoid-walk,531,ALM
64,800000,1600000,1600,2.2522576348507775,800000,14978.660773515701,humanoid-walk,531,ALM
65,812500,1625000,1625,3.158382870825762,812500,15213.7286028862,humanoid-walk,531,ALM
66,825000,1650000,1650,1.8532905382887528,825000,15446.725238084793,humanoid-walk,531,ALM
67,837500,1675000,1675,1.0773999543352732,837500,15686.191582918167,humanoid-walk,531,ALM
68,850000,1700000,1700,0.7854363017876309,850000,15916.967546701431,humanoid-walk,531,ALM
69,862500,1725000,1725,1.1467341201853405,862500,16152.454456329346,humanoid-walk,531,ALM
70,875000,1750000,1750,0.7797610266515079,875000,16384.664850473404,humanoid-walk,531,ALM
71,887500,1775000,1775,0.9558627848308724,887500,16615.398614645004,humanoid-walk,531,ALM
72,900000,1800000,1800,0.9775310636508561,900000,16845.698921442032,humanoid-walk,531,ALM
73,912500,1825000,1825,0.7914321938045124,912500,17076.48839354515,humanoid-walk,531,ALM
74,925000,1850000,1850,0.9090903074574991,925000,17307.997923851013,humanoid-walk,531,ALM
75,937500,1875000,1875,0.894120090766501,937500,17540.070377588272,humanoid-walk,531,ALM
76,950000,1900000,1900,1.4402909006836158,950000,17772.018404483795,humanoid-walk,531,ALM
77,962500,1925000,1925,1.3955974975800998,962500,18003.06394481659,humanoid-walk,531,ALM
78,975000,1950000,1950,1.005483840449771,975000,18235.693861961365,humanoid-walk,531,ALM
79,987500,1975000,1975,0.9323467955546793,987500,18467.892679452896,humanoid-walk,531,ALM
80,1000000,2000000,2000,0.7973638888702765,1000000,18700.236268520355,humanoid-walk,531,ALM
81,1012500,2025000,2025,2.438332797386468,1012500,18932.58673810959,humanoid-walk,531,ALM
82,1025000,2050000,2050,2.823771803141309,1025000,19165.561416864395,humanoid-walk,531,ALM
83,1037500,2075000,2075,0.8254572368705675,1037500,19398.424988746643,humanoid-walk,531,ALM
84,1050000,2100000,2100,1.123328763199382,1050000,19637.194987535477,humanoid-walk,531,ALM
85,1062500,2125000,2125,1.5867523206773002,1062500,19871.495687246323,humanoid-walk,531,ALM
86,1075000,2150000,2150,2.410616416550016,1075000,20105.811143398285,humanoid-walk,531,ALM
87,1087500,2175000,2175,0.8634356718625321,1087500,20339.804089307785,humanoid-walk,531,ALM
88,1100000,2200000,2200,1.0701312581233273,1100000,20571.464595794678,humanoid-walk,531,ALM
89,1112500,2225000,2225,0.8250197065475605,1112500,20802.07863521576,humanoid-walk,531,ALM
90,1125000,2250000,2250,0.8602795757537738,1125000,21035.597872018814,humanoid-walk,531,ALM
91,1137500,2275000,2275,0.705553405268251,1137500,21269.362941980362,humanoid-walk,531,ALM
92,1150000,2300000,2300,1.0997313843572898,1150000,21502.221047639847,humanoid-walk,531,ALM
93,1162500,2325000,2325,1.7397242208340291,1162500,21735.213465690613,humanoid-walk,531,ALM
94,1175000,2350000,2350,3.0649782059728605,1175000,21968.436623334885,humanoid-walk,531,ALM
95,1187500,2375000,2375,0.4203592260763143,1187500,22201.981657981873,humanoid-walk,531,ALM
96,1200000,2400000,2400,1.7654329816858787,1200000,22435.321671009064,humanoid-walk,531,ALM
97,1212500,2425000,2425,1.8745353095448998,1212500,22668.59357047081,humanoid-walk,531,ALM
98,1225000,2450000,2450,1.583602253458321,1225000,22901.874688863754,humanoid-walk,531,ALM
99,1237500,2475000,2475,1.0210379957041216,1237500,23135.38202023506,humanoid-walk,531,ALM
100,1250000,2500000,2500,0.741846057433513,1250000,23369.024215698242,humanoid-walk,531,ALM
101,1262500,2525000,2525,0.8688767835594089,1262500,23606.49960422516,humanoid-walk,531,ALM
102,1275000,2550000,2550,1.0622829085034158,1275000,23841.605914115906,humanoid-walk,531,ALM
103,1287500,2575000,2575,2.0622360062983605,1287500,24074.579520225525,humanoid-walk,531,ALM
104,1300000,2600000,2600,0.678441922356132,1300000,24306.330417394638,humanoid-walk,531,ALM
105,1312500,2625000,2625,1.57186515750404,1312500,24537.993601322174,humanoid-walk,531,ALM
106,1325000,2650000,2650,0.9494180280181024,1325000,24769.677976369858,humanoid-walk,531,ALM
107,1337500,2675000,2675,1.243886697587139,1337500,25003.066254854202,humanoid-walk,531,ALM
108,1350000,2700000,2700,2.131012773103258,1350000,25236.81895685196,humanoid-walk,531,ALM
109,1362500,2725000,2725,0.902645897814027,1362500,25466.47957277298,humanoid-walk,531,ALM
110,1375000,2750000,2750,1.7686834668658729,1375000,25699.14742088318,humanoid-walk,531,ALM
111,1387500,2775000,2775,0.9434783959588146,1387500,25933.20444583893,humanoid-walk,531,ALM
112,1400000,2800000,2800,0.8118488967705251,1400000,26165.844389915466,humanoid-walk,531,ALM
113,1412500,2825000,2825,2.8362218122804963,1412500,26397.70949935913,humanoid-walk,531,ALM
114,1425000,2850000,2850,1.6151906504769837,1425000,26629.45138001442,humanoid-walk,531,ALM
115,1437500,2875000,2875,1.7589498856183703,1437500,26860.920101881027,humanoid-walk,531,ALM
116,1450000,2900000,2900,1.120879233639759,1450000,27091.61464571953,humanoid-walk,531,ALM
117,1462500,2925000,2925,3.2897186406049967,1462500,27326.028078079224,humanoid-walk,531,ALM
118,1475000,2950000,2950,0.4164435683355195,1475000,27559.299857854843,humanoid-walk,531,ALM
119,1487500,2975000,2975,0.9951996483034116,1487500,27795.06758761406,humanoid-walk,531,ALM
120,1500000,3000000,3000,0.9038712536326405,1500000,28028.123610258102,humanoid-walk,531,ALM
121,1512500,3025000,3025,0.8908451497894678,1512500,28261.57984828949,humanoid-walk,531,ALM
122,1525000,3050000,3050,0.7991711859942212,1525000,28494.19742488861,humanoid-walk,531,ALM
123,1537500,3075000,3075,1.416338227789591,1537500,28728.976061344147,humanoid-walk,531,ALM
124,1550000,3100000,3100,2.3673048904719063,1550000,28961.563657283783,humanoid-walk,531,ALM
125,1562500,3125000,3125,1.2861187075875269,1562500,29195.32816386223,humanoid-walk,531,ALM
126,1575000,3150000,3150,1.8638648559936892,1575000,29428.456976890564,humanoid-walk,531,ALM
127,1587500,3175000,3175,1.5637272824389685,1587500,29660.792012929916,humanoid-walk,531,ALM
128,1600000,3200000,3200,1.5101468612362303,1600000,29891.77202153206,humanoid-walk,531,ALM
129,1612500,3225000,3225,3.193891051975791,1612500,30122.18599486351,humanoid-walk,531,ALM
130,1625000,3250000,3250,0.8576553269180209,1625000,30355.971173286438,humanoid-walk,531,ALM
131,1637500,3275000,3275,1.1789712048451269,1637500,30588.512949466705,humanoid-walk,531,ALM
132,1650000,3300000,3300,1.160030185539036,1650000,30822.43966269493,humanoid-walk,531,ALM
133,1662500,3325000,3325,0.9920647139546869,1662500,31054.62116265297,humanoid-walk,531,ALM
134,1675000,3350000,3350,0.9002455552010178,1675000,31289.573662519455,humanoid-walk,531,ALM
135,1687500,3375000,3375,3.1743914264543536,1687500,31523.920288801193,humanoid-walk,531,ALM
136,1700000,3400000,3400,4.07345353369937,1700000,31756.5187728405,humanoid-walk,531,ALM
137,1712500,3425000,3425,0.9972788327508532,1712500,31989.19208264351,humanoid-walk,531,ALM
138,1725000,3450000,3450,1.3052535254692395,1725000,32222.41045689583,humanoid-walk,531,ALM
139,1737500,3475000,3475,0.8597673712009056,1737500,32454.20228457451,humanoid-walk,531,ALM
140,1750000,3500000,3500,0.5633808821229451,1750000,32684.80197453499,humanoid-walk,531,ALM
141,1762500,3525000,3525,0.7995782425129476,1762500,32915.75013136864,humanoid-walk,531,ALM
142,1775000,3550000,3550,1.6008655366856395,1775000,33148.04895043373,humanoid-walk,531,ALM
143,1787500,3575000,3575,1.6498452540218183,1787500,33379.90795493126,humanoid-walk,531,ALM
144,1800000,3600000,3600,4.266613415442787,1800000,33610.820753097534,humanoid-walk,531,ALM
145,1812500,3625000,3625,1.4003033157198481,1812500,33839.94019842148,humanoid-walk,531,ALM
146,1825000,3650000,3650,1.9094831050893397,1825000,34070.52651262283,humanoid-walk,531,ALM
147,1837500,3675000,3675,2.953266565909641,1837500,34302.53688144684,humanoid-walk,531,ALM
148,1850000,3700000,3700,2.347124513704012,1850000,34533.47078037262,humanoid-walk,531,ALM
149,1862500,3725000,3725,1.1453861846161932,1862500,34764.01300764084,humanoid-walk,531,ALM
150,1875000,3750000,3750,2.79229590903949,1875000,34996.576117277145,humanoid-walk,531,ALM
151,1887500,3775000,3775,1.5749339256661747,1887500,35235.277113199234,humanoid-walk,531,ALM
152,1900000,3800000,3800,1.491388652295658,1900000,35466.68780517578,humanoid-walk,531,ALM
153,1912500,3825000,3825,3.5680114669231684,1912500,35697.33419203758,humanoid-walk,531,ALM
154,1925000,3850000,3850,2.007190730959033,1925000,35930.24261760712,humanoid-walk,531,ALM
155,1937500,3875000,3875,2.815223032652527,1937500,36162.6620657444,humanoid-walk,531,ALM
156,1950000,3900000,3900,2.5079396561666654,1950000,36395.59267663956,humanoid-walk,531,ALM
157,1962500,3925000,3925,1.5551821877761463,1962500,36627.72741484642,humanoid-walk,531,ALM
158,1975000,3950000,3950,1.77622934018992,1975000,36859.71885204315,humanoid-walk,531,ALM
159,1987500,3975000,3975,3.5900763595206326,1987500,37089.74501776695,humanoid-walk,531,ALM
160,2000000,4000000,4000,2.339072826368015,2000000,37321.72066068649,humanoid-walk,531,ALM
161,2012500,4025000,4025,1.7664205434602198,2012500,37553.964899778366,humanoid-walk,531,ALM
162,2025000,4050000,4050,3.47156784376543,2025000,37786.161682367325,humanoid-walk,531,ALM
163,2037500,4075000,4075,1.2562174649605384,2037500,38017.846786260605,humanoid-walk,531,ALM
164,2050000,4100000,4100,0.7623767173138379,2050000,38251.07895946503,humanoid-walk,531,ALM
165,2062500,4125000,4125,1.9640348948102146,2062500,38481.357587337494,humanoid-walk,531,ALM
166,2075000,4150000,4150,0.8816196690876825,2075000,38712.90687537193,humanoid-walk,531,ALM
167,2087500,4175000,4175,3.6709771780977847,2087500,38944.80938696861,humanoid-walk,531,ALM
168,2100000,4200000,4200,0.8394159930270664,2100000,39182.01512145996,humanoid-walk,531,ALM
169,2112500,4225000,4225,1.3666105972030584,2112500,39411.95041036606,humanoid-walk,531,ALM
170,2125000,4250000,4250,1.6911083345353046,2125000,39642.43845653534,humanoid-walk,531,ALM
171,2137500,4275000,4275,1.4652555427824785,2137500,39874.467134952545,humanoid-walk,531,ALM
172,2150000,4300000,4300,0.9096683916185068,2150000,40104.40893697739,humanoid-walk,531,ALM
173,2162500,4325000,4325,1.3343152239693907,2162500,40342.912170648575,humanoid-walk,531,ALM
174,2175000,4350000,4350,2.730256055791328,2175000,40577.16593885422,humanoid-walk,531,ALM
175,2187500,4375000,4375,4.085576992179951,2187500,40811.43521976471,humanoid-walk,531,ALM
176,2200000,4400000,4400,2.628302902261628,2200000,41043.38516998291,humanoid-walk,531,ALM
177,2212500,4425000,4425,2.5510742501886683,2212500,41274.31817984581,humanoid-walk,531,ALM
178,2225000,4450000,4450,3.9157122301135177,2225000,41506.36458706856,humanoid-walk,531,ALM
179,2237500,4475000,4475,0.5991815336027436,2237500,41738.353128910065,humanoid-walk,531,ALM
180,2250000,4500000,4500,0.765516217008526,2250000,41970.343935489655,humanoid-walk,531,ALM
181,2262500,4525000,4525,1.8992276840066515,2262500,42200.98681640625,humanoid-walk,531,ALM
182,2275000,4550000,4550,4.368430074948342,2275000,42433.766281843185,humanoid-walk,531,ALM
183,2287500,4575000,4575,1.2143571107605216,2287500,42664.52632069588,humanoid-walk,531,ALM
184,2300000,4600000,4600,2.374154715525724,2300000,42898.56976032257,humanoid-walk,531,ALM
185,2312500,4625000,4625,1.38613094393971,2312500,43131.982409477234,humanoid-walk,531,ALM
186,2325000,4650000,4650,1.012318487095542,2325000,43365.6274368763,humanoid-walk,531,ALM
187,2337500,4675000,4675,1.0118891565433517,2337500,43597.56084418297,humanoid-walk,531,ALM
188,2350000,4700000,4700,3.460336887939973,2350000,43829.27376937866,humanoid-walk,531,ALM
189,2362500,4725000,4725,1.5543737735191612,2362500,44062.94715952873,humanoid-walk,531,ALM
190,2375000,4750000,4750,2.474992271148222,2375000,44296.34487462044,humanoid-walk,531,ALM
191,2387500,4775000,4775,0.7770084209327399,2387500,44529.25698685646,humanoid-walk,531,ALM
192,2400000,4800000,4800,3.154450239088544,2400000,44764.973346710205,humanoid-walk,531,ALM
193,2412500,4825000,4825,2.607765579830078,2412500,44996.49516367912,humanoid-walk,531,ALM
194,2425000,4850000,4850,1.7250349341803968,2425000,45227.02585411072,humanoid-walk,531,ALM
195,2437500,4875000,4875,0.9191901728313849,2437500,45458.747185230255,humanoid-walk,531,ALM
196,2450000,4900000,4900,3.286682063238888,2450000,45691.53577184677,humanoid-walk,531,ALM
197,2462500,4925000,4925,1.9705316518232099,2462500,45919.26712298393,humanoid-walk,531,ALM
198,2475000,4950000,4950,3.7202213395536865,2475000,46150.81408262253,humanoid-walk,531,ALM
199,2487500,4975000,4975,2.4735643776696117,2487500,46381.46296834946,humanoid-walk,531,ALM
0,0,0,0,0.885851915586229,0,18.366663217544556,humanoid-walk,858,ALM
1,12500,25000,25,1.2873457696506116,12500,246.27854990959167,humanoid-walk,858,ALM
2,25000,50000,50,0.866607532791377,25000,492.563401222229,humanoid-walk,858,ALM
3,37500,75000,75,1.0201711601501322,37500,736.7918059825897,humanoid-walk,858,ALM
4,50000,100000,100,0.7576127946232641,50000,980.6327426433563,humanoid-walk,858,ALM
5,62500,125000,125,0.810375872070183,62500,1226.349555015564,humanoid-walk,858,ALM
6,75000,150000,150,1.0044063393467344,75000,1470.2572901248932,humanoid-walk,858,ALM
7,87500,175000,175,1.0550306078284604,87500,1714.8123381137848,humanoid-walk,858,ALM
8,100000,200000,200,1.2168981707342144,100000,1956.5639953613281,humanoid-walk,858,ALM
9,112500,225000,225,1.0083698674903905,112500,2195.7400453090668,humanoid-walk,858,ALM
10,125000,250000,250,0.6450036378724056,125000,2436.5407617092133,humanoid-walk,858,ALM
11,137500,275000,275,1.0249362546423073,137500,2678.937578201294,humanoid-walk,858,ALM
12,150000,300000,300,0.9764794662070926,150000,2921.656895637512,humanoid-walk,858,ALM
13,162500,325000,325,0.8157176301490017,162500,3162.013960838318,humanoid-walk,858,ALM
14,175000,350000,350,1.0333375962139475,175000,3402.7712922096252,humanoid-walk,858,ALM
15,187500,375000,375,1.4004203848123662,187500,3642.886356830597,humanoid-walk,858,ALM
16,200000,400000,400,1.1577723644171063,200000,3889.7680706977844,humanoid-walk,858,ALM
17,212500,425000,425,1.1642018499226832,212500,4137.135129213333,humanoid-walk,858,ALM
18,225000,450000,450,1.2253707780530536,225000,4378.030388355255,humanoid-walk,858,ALM
19,237500,475000,475,1.0578131480799267,237500,4617.212012052536,humanoid-walk,858,ALM
20,250000,500000,500,1.1149293535901212,250000,4851.813771009445,humanoid-walk,858,ALM
21,262500,525000,525,1.212828591423814,262500,5094.387934207916,humanoid-walk,858,ALM
22,275000,550000,550,1.3070527118198914,275000,5337.431407213211,humanoid-walk,858,ALM
23,287500,575000,575,1.5260507017524063,287500,5580.12552690506,humanoid-walk,858,ALM
24,300000,600000,600,0.769378922934326,300000,5822.341904878616,humanoid-walk,858,ALM
25,312500,625000,625,1.162437582339218,312500,6063.550232172012,humanoid-walk,858,ALM
26,325000,650000,650,1.2633360712297805,325000,6304.044574737549,humanoid-walk,858,ALM
27,337500,675000,675,1.155312251622952,337500,6543.866805553436,humanoid-walk,858,ALM
28,350000,700000,700,0.9176634555082697,350000,6785.311815261841,humanoid-walk,858,ALM
29,362500,725000,725,1.6516584729719868,362500,7025.5167326927185,humanoid-walk,858,ALM
30,375000,750000,750,1.0997735392485222,375000,7263.021164417267,humanoid-walk,858,ALM
31,387500,775000,775,0.8803516254787184,387500,7499.786959409714,humanoid-walk,858,ALM
32,400000,800000,800,1.23002748258307,400000,7739.068059921265,humanoid-walk,858,ALM
33,412500,825000,825,1.3781167167697113,412500,7989.897519826889,humanoid-walk,858,ALM
34,425000,850000,850,0.8440511551960108,425000,8231.708917617798,humanoid-walk,858,ALM
35,437500,875000,875,2.159698773466178,437500,8473.862622737885,humanoid-walk,858,ALM
36,450000,900000,900,2.474953654024925,450000,8715.316363811493,humanoid-walk,858,ALM
37,462500,925000,925,1.2097936214090268,462500,8955.134617090225,humanoid-walk,858,ALM
38,475000,950000,950,1.3250881876329008,475000,9194.102288246155,humanoid-walk,858,ALM
39,487500,975000,975,1.2652642265061194,487500,9434.00231719017,humanoid-walk,858,ALM
40,500000,1000000,1000,1.1590632855931817,500000,9676.56571984291,humanoid-walk,858,ALM
41,512500,1025000,1025,0.873377306188803,512500,9918.418126821518,humanoid-walk,858,ALM
42,525000,1050000,1050,1.1266913357738433,525000,10153.844438314438,humanoid-walk,858,ALM
43,537500,1075000,1075,0.9729991089178929,537500,10393.408363580704,humanoid-walk,858,ALM
44,550000,1100000,1100,0.9861989646591033,550000,10634.830580949783,humanoid-walk,858,ALM
45,562500,1125000,1125,1.410150610512253,562500,10875.578904628754,humanoid-walk,858,ALM
46,575000,1150000,1150,0.9187005438042384,575000,11115.926228046417,humanoid-walk,858,ALM
47,587500,1175000,1175,1.0029890985598298,587500,11357.984739303589,humanoid-walk,858,ALM
48,600000,1200000,1200,1.4207443993239424,600000,11598.101798295975,humanoid-walk,858,ALM
49,612500,1225000,1225,1.1699396689923964,612500,11850.235600948334,humanoid-walk,858,ALM
50,625000,1250000,1250,1.3106973539786142,625000,12090.97514128685,humanoid-walk,858,ALM
51,637500,1275000,1275,2.4333275439777506,637500,12331.204997062683,humanoid-walk,858,ALM
52,650000,1300000,1300,1.5895990915493525,650000,12573.207319259644,humanoid-walk,858,ALM
53,662500,1325000,1325,3.8568203471419453,662500,12808.794124126434,humanoid-walk,858,ALM
54,675000,1350000,1350,0.7308165627864182,675000,13045.861862897873,humanoid-walk,858,ALM
55,687500,1375000,1375,0.925726385142277,687500,13287.343573570251,humanoid-walk,858,ALM
56,700000,1400000,1400,0.8271736464399646,700000,13528.069848537445,humanoid-walk,858,ALM
57,712500,1425000,1425,1.1738884283268984,712500,13770.05381679535,humanoid-walk,858,ALM
58,725000,1450000,1450,0.9252994718250049,725000,14009.419363975525,humanoid-walk,858,ALM
59,737500,1475000,1475,1.2148737302012957,737500,14251.80898308754,humanoid-walk,858,ALM
60,750000,1500000,1500,1.113360549296068,750000,14492.815210103989,humanoid-walk,858,ALM
61,762500,1525000,1525,0.8490690355140339,762500,14733.290867805481,humanoid-walk,858,ALM
62,775000,1550000,1550,1.387009337968481,775000,14972.472666740417,humanoid-walk,858,ALM
63,787500,1575000,1575,0.8984513763477924,787500,15212.750707149506,humanoid-walk,858,ALM
64,800000,1600000,1600,1.4975722869185573,800000,15447.908472776413,humanoid-walk,858,ALM
65,812500,1625000,1625,1.0611975472942432,812500,15687.656866550446,humanoid-walk,858,ALM
66,825000,1650000,1650,0.9407426740034296,825000,15929.821078777313,humanoid-walk,858,ALM
67,837500,1675000,1675,1.4206900382398413,837500,16170.863764047623,humanoid-walk,858,ALM
68,850000,1700000,1700,1.1447597675446768,850000,16411.586937189102,humanoid-walk,858,ALM
69,862500,1725000,1725,1.1565106357665504,862500,16652.614598751068,humanoid-walk,858,ALM
70,875000,1750000,1750,0.8655240735103421,875000,16891.808951854706,humanoid-walk,858,ALM
71,887500,1775000,1775,0.6903830748770611,887500,17132.16783618927,humanoid-walk,858,ALM
72,900000,1800000,1800,2.8466953021713506,900000,17373.606451511383,humanoid-walk,858,ALM
73,912500,1825000,1825,1.714223074090692,912500,17614.80876326561,humanoid-walk,858,ALM
74,925000,1850000,1850,0.9388335919234485,925000,17855.830988645554,humanoid-walk,858,ALM
75,937500,1875000,1875,1.532715657515289,937500,18092.36253452301,humanoid-walk,858,ALM
76,950000,1900000,1900,1.0394973342090634,950000,18326.567342042923,humanoid-walk,858,ALM
77,962500,1925000,1925,1.2663703910737263,962500,18564.370347499847,humanoid-walk,858,ALM
78,975000,1950000,1950,0.867399895756251,975000,18806.110155582428,humanoid-walk,858,ALM
79,987500,1975000,1975,1.0350186985412586,987500,19045.73923420906,humanoid-walk,858,ALM
80,1000000,2000000,2000,1.8303128372780386,1000000,19287.225921154022,humanoid-walk,858,ALM
81,1012500,2025000,2025,1.7951555894550233,1012500,19535.402717590332,humanoid-walk,858,ALM
82,1025000,2050000,2050,1.8612995084226944,1025000,19777.725838661194,humanoid-walk,858,ALM
83,1037500,2075000,2075,1.5285743961905025,1037500,20021.226947546005,humanoid-walk,858,ALM
84,1050000,2100000,2100,1.2435542226205012,1050000,20262.804095506668,humanoid-walk,858,ALM
85,1062500,2125000,2125,1.2610826825827108,1062500,20503.55216383934,humanoid-walk,858,ALM
86,1075000,2150000,2150,2.2214823155943515,1075000,20742.501051425934,humanoid-walk,858,ALM
87,1087500,2175000,2175,1.9865763672687493,1087500,20977.15418124199,humanoid-walk,858,ALM
88,1100000,2200000,2200,2.6485725800759328,1100000,21210.988470077515,humanoid-walk,858,ALM
89,1112500,2225000,2225,0.7027151624502849,1112500,21450.988708257675,humanoid-walk,858,ALM
90,1125000,2250000,2250,1.4104753250142283,1125000,21693.18699336052,humanoid-walk,858,ALM
91,1137500,2275000,2275,1.300289219159112,1137500,21934.197504520416,humanoid-walk,858,ALM
92,1150000,2300000,2300,1.535403502834932,1150000,22174.313876628876,humanoid-walk,858,ALM
93,1162500,2325000,2325,0.7521006555969619,1162500,22415.646468877792,humanoid-walk,858,ALM
94,1175000,2350000,2350,1.029831921187939,1175000,22656.36314034462,humanoid-walk,858,ALM
95,1187500,2375000,2375,1.1878383680106734,1187500,22897.769285440445,humanoid-walk,858,ALM
96,1200000,2400000,2400,1.934221949676326,1200000,23137.038234233856,humanoid-walk,858,ALM
97,1212500,2425000,2425,2.0354185443641546,1212500,23377.69691967964,humanoid-walk,858,ALM
98,1225000,2450000,2450,1.33519403552519,1225000,23617.71345925331,humanoid-walk,858,ALM
99,1237500,2475000,2475,1.5010040000629126,1237500,23853.289727449417,humanoid-walk,858,ALM
100,1250000,2500000,2500,1.2398655238541483,1250000,24091.818905591965,humanoid-walk,858,ALM
101,1262500,2525000,2525,0.8054663481842483,1262500,24332.67142510414,humanoid-walk,858,ALM
102,1275000,2550000,2550,1.5405902500950277,1275000,24574.40869307518,humanoid-walk,858,ALM
103,1287500,2575000,2575,2.1552716100549065,1287500,24814.46827363968,humanoid-walk,858,ALM
104,1300000,2600000,2600,0.8799602264373279,1300000,25056.15768098831,humanoid-walk,858,ALM
105,1312500,2625000,2625,0.8548722441528834,1312500,25298.245406627655,humanoid-walk,858,ALM
106,1325000,2650000,2650,1.2764120216220456,1325000,25539.629659175873,humanoid-walk,858,ALM
107,1337500,2675000,2675,2.2978309778169748,1337500,25781.490383148193,humanoid-walk,858,ALM
108,1350000,2700000,2700,1.280225894386088,1350000,26020.385976552963,humanoid-walk,858,ALM
109,1362500,2725000,2725,1.0624732363889027,1362500,26260.008805274963,humanoid-walk,858,ALM
110,1375000,2750000,2750,1.9117668544528066,1375000,26492.998770475388,humanoid-walk,858,ALM
111,1387500,2775000,2775,0.5553073589705664,1387500,26727.63166284561,humanoid-walk,858,ALM
112,1400000,2800000,2800,1.9847454278841379,1400000,26965.954654455185,humanoid-walk,858,ALM
113,1412500,2825000,2825,1.0106448949261424,1412500,27206.80340194702,humanoid-walk,858,ALM
114,1425000,2850000,2850,1.225965700794519,1425000,27453.892518997192,humanoid-walk,858,ALM
115,1437500,2875000,2875,1.4344665715211258,1437500,27694.466159820557,humanoid-walk,858,ALM
116,1450000,2900000,2900,2.2511774374685904,1450000,27936.882687091827,humanoid-walk,858,ALM
117,1462500,2925000,2925,2.222418987145817,1462500,28177.832003116608,humanoid-walk,858,ALM
118,1475000,2950000,2950,1.1002704362422675,1475000,28420.403738975525,humanoid-walk,858,ALM
119,1487500,2975000,2975,2.5111415022269616,1487500,28662.629548311234,humanoid-walk,858,ALM
120,1500000,3000000,3000,1.1475368857242787,1500000,28901.487519025803,humanoid-walk,858,ALM
121,1512500,3025000,3025,1.402723016580173,1512500,29143.70251560211,humanoid-walk,858,ALM
122,1525000,3050000,3050,1.2536660122567356,1525000,29377.548734664917,humanoid-walk,858,ALM
123,1537500,3075000,3075,1.3443318317673167,1537500,29610.100872039795,humanoid-walk,858,ALM
124,1550000,3100000,3100,2.702707528286866,1550000,29850.92938041687,humanoid-walk,858,ALM
125,1562500,3125000,3125,1.6380699575258792,1562500,30091.65306329727,humanoid-walk,858,ALM
126,1575000,3150000,3150,2.067721141542645,1575000,30333.49103665352,humanoid-walk,858,ALM
127,1587500,3175000,3175,2.3983631574530366,1587500,30574.226065158844,humanoid-walk,858,ALM
128,1600000,3200000,3200,4.539524754625149,1600000,30815.61112356186,humanoid-walk,858,ALM
129,1612500,3225000,3225,1.7653261345525564,1612500,31055.83848643303,humanoid-walk,858,ALM
130,1625000,3250000,3250,1.556956424231065,1625000,31298.446556806564,humanoid-walk,858,ALM
131,1637500,3275000,3275,2.9765281346960846,1637500,31536.84129667282,humanoid-walk,858,ALM
132,1650000,3300000,3300,0.9140980914762411,1650000,31777.770204544067,humanoid-walk,858,ALM
133,1662500,3325000,3325,2.469268328396501,1662500,32017.352810144424,humanoid-walk,858,ALM
134,1675000,3350000,3350,4.587175986772431,1675000,32250.637970924377,humanoid-walk,858,ALM
135,1687500,3375000,3375,2.38777139703621,1687500,32486.543674230576,humanoid-walk,858,ALM
136,1700000,3400000,3400,2.0470832669206294,1700000,32727.517966747284,humanoid-walk,858,ALM
137,1712500,3425000,3425,2.8563021112125178,1712500,32968.17764401436,humanoid-walk,858,ALM
138,1725000,3450000,3450,2.5332399876249108,1725000,33210.96569657326,humanoid-walk,858,ALM
139,1737500,3475000,3475,2.0502689246129693,1737500,33451.78679943085,humanoid-walk,858,ALM
140,1750000,3500000,3500,2.7628879720509536,1750000,33693.35289025307,humanoid-walk,858,ALM
141,1762500,3525000,3525,2.371740583138809,1762500,33933.148899793625,humanoid-walk,858,ALM
142,1775000,3550000,3550,2.2012178965466043,1775000,34174.23460841179,humanoid-walk,858,ALM
143,1787500,3575000,3575,1.066879340305325,1787500,34414.49603629112,humanoid-walk,858,ALM
144,1800000,3600000,3600,1.9725861501965158,1800000,34655.810462236404,humanoid-walk,858,ALM
145,1812500,3625000,3625,1.5278992643527676,1812500,34894.84646296501,humanoid-walk,858,ALM
146,1825000,3650000,3650,2.341069214025238,1825000,35130.8348941803,humanoid-walk,858,ALM
147,1837500,3675000,3675,3.363543809470392,1837500,35371.53314089775,humanoid-walk,858,ALM
148,1850000,3700000,3700,1.3300439580285932,1850000,35611.99590301514,humanoid-walk,858,ALM
149,1862500,3725000,3725,1.576211546599596,1862500,35853.31230664253,humanoid-walk,858,ALM
150,1875000,3750000,3750,1.456583339373295,1875000,36093.95004272461,humanoid-walk,858,ALM
151,1887500,3775000,3775,1.9881793043692106,1887500,36335.81142163277,humanoid-walk,858,ALM
152,1900000,3800000,3800,0.8176264956093984,1900000,36576.318032979965,humanoid-walk,858,ALM
153,1912500,3825000,3825,2.0512795493788287,1912500,36818.45289230347,humanoid-walk,858,ALM
154,1925000,3850000,3850,3.1640537147781638,1925000,37059.66295528412,humanoid-walk,858,ALM
155,1937500,3875000,3875,4.2799213139808545,1937500,37300.683686733246,humanoid-walk,858,ALM
156,1950000,3900000,3900,6.65535114174926,1950000,37542.36216831207,humanoid-walk,858,ALM
157,1962500,3925000,3925,2.7113334653676175,1962500,37778.298078775406,humanoid-walk,858,ALM
158,1975000,3950000,3950,2.7345368372147796,1975000,38015.83193421364,humanoid-walk,858,ALM
159,1987500,3975000,3975,1.589812220381217,1987500,38256.70881652832,humanoid-walk,858,ALM
160,2000000,4000000,4000,1.6103466659154946,2000000,38496.81928396225,humanoid-walk,858,ALM
161,2012500,4025000,4025,1.9384573319895246,2012500,38737.49761891365,humanoid-walk,858,ALM
162,2025000,4050000,4050,7.183226928049313,2025000,38976.91826057434,humanoid-walk,858,ALM
163,2037500,4075000,4075,5.413997970228064,2037500,39219.195694446564,humanoid-walk,858,ALM
164,2050000,4100000,4100,4.454673252454848,2050000,39459.96096801758,humanoid-walk,858,ALM
165,2062500,4125000,4125,4.1313040838960635,2062500,39700.05734682083,humanoid-walk,858,ALM
166,2075000,4150000,4150,3.2140115789851484,2075000,39940.38668966293,humanoid-walk,858,ALM
167,2087500,4175000,4175,2.7650808733015295,2087500,40180.8050801754,humanoid-walk,858,ALM
168,2100000,4200000,4200,7.871756608832124,2100000,40419.96640253067,humanoid-walk,858,ALM
169,2112500,4225000,4225,3.2609909318688173,2112500,40653.655359745026,humanoid-walk,858,ALM
170,2125000,4250000,4250,4.935830451911674,2125000,40893.38727593422,humanoid-walk,858,ALM
171,2137500,4275000,4275,3.507596744269854,2137500,41134.85513329506,humanoid-walk,858,ALM
172,2150000,4300000,4300,0.7677388075648536,2150000,41375.698909044266,humanoid-walk,858,ALM
173,2162500,4325000,4325,5.46416378449998,2162500,41616.7496907711,humanoid-walk,858,ALM
174,2175000,4350000,4350,6.553683817430934,2175000,41855.83474254608,humanoid-walk,858,ALM
175,2187500,4375000,4375,7.138582935351195,2187500,42097.09797120094,humanoid-walk,858,ALM
176,2200000,4400000,4400,6.385682776321128,2200000,42338.56665015221,humanoid-walk,858,ALM
177,2212500,4425000,4425,5.911511603654995,2212500,42579.14946651459,humanoid-walk,858,ALM
178,2225000,4450000,4450,5.226418145290366,2225000,42818.93194413185,humanoid-walk,858,ALM
179,2237500,4475000,4475,5.4826796169403895,2237500,43065.700431108475,humanoid-walk,858,ALM
180,2250000,4500000,4500,4.783875919296871,2250000,43303.3049800396,humanoid-walk,858,ALM
181,2262500,4525000,4525,9.175259389453696,2262500,43535.382536649704,humanoid-walk,858,ALM
182,2275000,4550000,4550,4.494011778522024,2275000,43772.587836265564,humanoid-walk,858,ALM
183,2287500,4575000,4575,5.936018257730533,2287500,44017.13734841347,humanoid-walk,858,ALM
184,2300000,4600000,4600,4.3076813679591,2300000,44253.773840904236,humanoid-walk,858,ALM
185,2312500,4625000,4625,9.17276581546753,2312500,44493.71437215805,humanoid-walk,858,ALM
186,2325000,4650000,4650,4.889351570546208,2325000,44735.04118466377,humanoid-walk,858,ALM
187,2337500,4675000,4675,5.576915130943389,2337500,44975.7194378376,humanoid-walk,858,ALM
188,2350000,4700000,4700,4.0395030814685615,2350000,45216.242053985596,humanoid-walk,858,ALM
189,2362500,4725000,4725,4.581471735676539,2362500,45457.36320352554,humanoid-walk,858,ALM
190,2375000,4750000,4750,4.2288077706575455,2375000,45696.02432489395,humanoid-walk,858,ALM
191,2387500,4775000,4775,7.687366001521385,2387500,45936.23085999489,humanoid-walk,858,ALM
192,2400000,4800000,4800,8.477943437516625,2400000,46172.724393844604,humanoid-walk,858,ALM
193,2412500,4825000,4825,2.511101358901853,2412500,46409.88078427315,humanoid-walk,858,ALM
194,2425000,4850000,4850,5.561107970331308,2425000,46651.4636361599,humanoid-walk,858,ALM
195,2437500,4875000,4875,5.5037055752058395,2437500,46897.40462017059,humanoid-walk,858,ALM
196,2450000,4900000,4900,6.99380776238173,2450000,47141.527661800385,humanoid-walk,858,ALM
197,2462500,4925000,4925,4.156086443289442,2462500,47383.64699149132,humanoid-walk,858,ALM
198,2475000,4950000,4950,3.253690872790814,2475000,47625.12106966972,humanoid-walk,858,ALM
199,2487500,4975000,4975,5.4474991447372885,2487500,47864.71938896179,humanoid-walk,858,ALM
0,0,0,0,0.8944120749301465,0,19.881260871887207,humanoid-walk,376,ALM
1,12500,25000,25,1.0094509576186688,12500,245.68326902389526,humanoid-walk,376,ALM
2,25000,50000,50,1.1768268557625015,25000,472.4138731956482,humanoid-walk,376,ALM
3,37500,75000,75,1.105971906865359,37500,698.5311641693115,humanoid-walk,376,ALM
4,50000,100000,100,1.06975174573029,50000,925.4126241207123,humanoid-walk,376,ALM
5,62500,125000,125,0.7304153032509929,62500,1152.056186914444,humanoid-walk,376,ALM
6,75000,150000,150,1.4525684161865018,75000,1379.0776557922363,humanoid-walk,376,ALM
7,87500,175000,175,1.7279781151255862,87500,1607.1633908748627,humanoid-walk,376,ALM
8,100000,200000,200,1.303580186714217,100000,1837.1738965511322,humanoid-walk,376,ALM
9,112500,225000,225,1.1334480287684001,112500,2065.5843749046326,humanoid-walk,376,ALM
10,125000,250000,250,0.8597245664629967,125000,2307.7306003570557,humanoid-walk,376,ALM
11,137500,275000,275,1.609667351737836,137500,2546.2066056728363,humanoid-walk,376,ALM
12,150000,300000,300,1.145537370023776,150000,2785.673420906067,humanoid-walk,376,ALM
13,162500,325000,325,1.3434803754764995,162500,3021.1215131282806,humanoid-walk,376,ALM
14,175000,350000,350,0.8438134942148625,175000,3260.600119829178,humanoid-walk,376,ALM
15,187500,375000,375,1.1690634626283232,187500,3499.388217687607,humanoid-walk,376,ALM
16,200000,400000,400,1.2524811842099175,200000,3742.8697073459625,humanoid-walk,376,ALM
17,212500,425000,425,1.0630389702366607,212500,3991.9655735492706,humanoid-walk,376,ALM
18,225000,450000,450,1.339797419392236,225000,4240.9319627285,humanoid-walk,376,ALM
19,237500,475000,475,1.0350949076606248,237500,4486.907612323761,humanoid-walk,376,ALM
20,250000,500000,500,1.0487076284749912,250000,4735.032358646393,humanoid-walk,376,ALM
21,262500,525000,525,0.7019851587614636,262500,4975.004598379135,humanoid-walk,376,ALM
22,275000,550000,550,1.5195413727571014,275000,5209.750695705414,humanoid-walk,376,ALM
23,287500,575000,575,1.3884914454595894,287500,5445.941065311432,humanoid-walk,376,ALM
24,300000,600000,600,2.366723481546953,300000,5683.517363071442,humanoid-walk,376,ALM
25,312500,625000,625,1.498586500927551,312500,5928.787399530411,humanoid-walk,376,ALM
26,325000,650000,650,1.230122166679034,325000,6176.775974273682,humanoid-walk,376,ALM
27,337500,675000,675,1.0890606685834459,337500,6415.524135828018,humanoid-walk,376,ALM
28,350000,700000,700,1.1223429877952245,350000,6652.0267651081085,humanoid-walk,376,ALM
29,362500,725000,725,1.2055382671076877,362500,6887.967063426971,humanoid-walk,376,ALM
30,375000,750000,750,1.1712929404191148,375000,7122.4777727127075,humanoid-walk,376,ALM
31,387500,775000,775,1.4274953688263952,387500,7358.41357421875,humanoid-walk,376,ALM
32,400000,800000,800,1.1701844650332447,400000,7595.695459604263,humanoid-walk,376,ALM
33,412500,825000,825,1.3026103906492126,412500,7830.828816413879,humanoid-walk,376,ALM
34,425000,850000,850,0.9002086779525753,425000,8066.493718862534,humanoid-walk,376,ALM
35,437500,875000,875,1.0946754304666975,437500,8300.907989740372,humanoid-walk,376,ALM
36,450000,900000,900,1.3561234069975847,450000,8537.71783542633,humanoid-walk,376,ALM
37,462500,925000,925,1.844173341082572,462500,8773.759877204895,humanoid-walk,376,ALM
38,475000,950000,950,1.1810480438986077,475000,9009.434518575668,humanoid-walk,376,ALM
39,487500,975000,975,0.989753183570157,487500,9244.4251101017,humanoid-walk,376,ALM
40,500000,1000000,1000,1.1779385965554134,500000,9481.812918424606,humanoid-walk,376,ALM
41,512500,1025000,1025,2.0008436676640295,512500,9717.656199932098,humanoid-walk,376,ALM
42,525000,1050000,1050,2.525535979978239,525000,9963.108923435211,humanoid-walk,376,ALM
43,537500,1075000,1075,0.8707118159068677,537500,10200.21546125412,humanoid-walk,376,ALM
44,550000,1100000,1100,1.648125017712092,550000,10439.285947799683,humanoid-walk,376,ALM
45,562500,1125000,1125,1.2550659873092525,562500,10675.259415626526,humanoid-walk,376,ALM
46,575000,1150000,1150,1.893640913009163,575000,10914.368382692337,humanoid-walk,376,ALM
47,587500,1175000,1175,1.9095388356574872,587500,11147.914993286133,humanoid-walk,376,ALM
48,600000,1200000,1200,1.3186395647870637,600000,11384.349588632584,humanoid-walk,376,ALM
49,612500,1225000,1225,1.200397236081189,612500,11620.120056152344,humanoid-walk,376,ALM
50,625000,1250000,1250,2.9082770533304023,625000,11856.022271633148,humanoid-walk,376,ALM
51,637500,1275000,1275,2.2562717478460774,637500,12091.619102716446,humanoid-walk,376,ALM
52,650000,1300000,1300,1.436722351134001,650000,12326.55022764206,humanoid-walk,376,ALM
53,662500,1325000,1325,0.9109169678032621,662500,12560.012578964233,humanoid-walk,376,ALM
54,675000,1350000,1350,1.3877578109253086,675000,12795.44617509842,humanoid-walk,376,ALM
55,687500,1375000,1375,1.0939095213768781,687500,13026.359525680542,humanoid-walk,376,ALM
56,700000,1400000,1400,1.5206073654849066,700000,13258.2687895298,humanoid-walk,376,ALM
57,712500,1425000,1425,2.488091378594271,712500,13490.705183029175,humanoid-walk,376,ALM
58,725000,1450000,1450,1.0430249760147612,725000,13727.941085577011,humanoid-walk,376,ALM
59,737500,1475000,1475,4.185750317357494,737500,13962.324252843857,humanoid-walk,376,ALM
60,750000,1500000,1500,1.302409813439747,750000,14197.625569581985,humanoid-walk,376,ALM
61,762500,1525000,1525,1.0219102279613326,762500,14435.614225625992,humanoid-walk,376,ALM
62,775000,1550000,1550,0.9195284587419865,775000,14669.339953899384,humanoid-walk,376,ALM
63,787500,1575000,1575,0.9235673294475049,787500,14908.666353940964,humanoid-walk,376,ALM
64,800000,1600000,1600,0.7114887492314326,800000,15143.969658374786,humanoid-walk,376,ALM
65,812500,1625000,1625,0.9881729482526047,812500,15376.924869060516,humanoid-walk,376,ALM
66,825000,1650000,1650,0.7152235573140008,825000,15609.58103775978,humanoid-walk,376,ALM
67,837500,1675000,1675,1.7724066750891212,837500,15839.757697820663,humanoid-walk,376,ALM
68,850000,1700000,1700,0.9967862964382668,850000,16073.138226509094,humanoid-walk,376,ALM
69,862500,1725000,1725,2.402664358387688,862500,16309.098571062088,humanoid-walk,376,ALM
70,875000,1750000,1750,0.980860430658872,875000,16542.240716457367,humanoid-walk,376,ALM
71,887500,1775000,1775,1.1523578042773974,887500,16772.782859802246,humanoid-walk,376,ALM
72,900000,1800000,1800,2.1585710931517452,900000,17006.1312186718,humanoid-walk,376,ALM
73,912500,1825000,1825,2.2705503642834177,912500,17239.109142303467,humanoid-walk,376,ALM
74,925000,1850000,1850,0.9752200264203944,925000,17471.894122838974,humanoid-walk,376,ALM
75,937500,1875000,1875,0.8639214998180108,937500,17705.051795482635,humanoid-walk,376,ALM
76,950000,1900000,1900,1.2381047293923189,950000,17936.844022750854,humanoid-walk,376,ALM
77,962500,1925000,1925,4.6306675325410245,962500,18173.108694553375,humanoid-walk,376,ALM
78,975000,1950000,1950,1.573091109396655,975000,18406.51008629799,humanoid-walk,376,ALM
79,987500,1975000,1975,1.761665663275,987500,18637.726994991302,humanoid-walk,376,ALM
80,1000000,2000000,2000,1.8660194774951588,1000000,18876.56689596176,humanoid-walk,376,ALM
81,1012500,2025000,2025,1.0417110323612437,1012500,19111.259724617004,humanoid-walk,376,ALM
82,1025000,2050000,2050,0.8933057209849158,1025000,19366.522252321243,humanoid-walk,376,ALM
83,1037500,2075000,2075,1.1585484438014486,1037500,19611.41286277771,humanoid-walk,376,ALM
84,1050000,2100000,2100,1.078765423204702,1050000,19844.70117878914,humanoid-walk,376,ALM
85,1062500,2125000,2125,1.482200764830572,1062500,20076.97160601616,humanoid-walk,376,ALM
86,1075000,2150000,2150,1.180260733155049,1075000,20312.58725142479,humanoid-walk,376,ALM
87,1087500,2175000,2175,2.398772794941602,1087500,20541.887912988663,humanoid-walk,376,ALM
88,1100000,2200000,2200,1.3272576783996122,1100000,20774.28831219673,humanoid-walk,376,ALM
89,1112500,2225000,2225,1.9188779109406968,1112500,21007.20415854454,humanoid-walk,376,ALM
90,1125000,2250000,2250,1.6956944261398808,1125000,21239.696511745453,humanoid-walk,376,ALM
91,1137500,2275000,2275,1.9141082336173938,1137500,21470.476036071777,humanoid-walk,376,ALM
92,1150000,2300000,2300,0.8241283469796444,1150000,21701.950765371323,humanoid-walk,376,ALM
93,1162500,2325000,2325,1.431950394923043,1162500,21934.572651147842,humanoid-walk,376,ALM
94,1175000,2350000,2350,1.349296124619085,1175000,22167.527324438095,humanoid-walk,376,ALM
95,1187500,2375000,2375,1.571134446917775,1187500,22397.662883520126,humanoid-walk,376,ALM
96,1200000,2400000,2400,1.1756499403555172,1200000,22630.0406165123,humanoid-walk,376,ALM
97,1212500,2425000,2425,1.3246277742779962,1212500,22868.90382552147,humanoid-walk,376,ALM
98,1225000,2450000,2450,1.03957477166837,1225000,23099.866707086563,humanoid-walk,376,ALM
99,1237500,2475000,2475,0.8828287361197583,1237500,23331.349005699158,humanoid-walk,376,ALM
100,1250000,2500000,2500,1.2538074920543023,1250000,23570.21821975708,humanoid-walk,376,ALM
101,1262500,2525000,2525,2.242424399606885,1262500,23804.17587542534,humanoid-walk,376,ALM
102,1275000,2550000,2550,2.1790894425471476,1275000,24035.44731283188,humanoid-walk,376,ALM
103,1287500,2575000,2575,3.0612556961030624,1287500,24268.20067024231,humanoid-walk,376,ALM
104,1300000,2600000,2600,1.1289012038371933,1300000,24499.44441461563,humanoid-walk,376,ALM
105,1312500,2625000,2625,1.2946921388856352,1312500,24733.648802280426,humanoid-walk,376,ALM
106,1325000,2650000,2650,3.564595360852568,1325000,24963.284234046936,humanoid-walk,376,ALM
107,1337500,2675000,2675,5.288220713885815,1337500,25197.060792922974,humanoid-walk,376,ALM
108,1350000,2700000,2700,5.122715403835917,1350000,25429.6979470253,humanoid-walk,376,ALM
109,1362500,2725000,2725,1.8240208731635537,1362500,25662.61203598976,humanoid-walk,376,ALM
110,1375000,2750000,2750,1.0118889258004693,1375000,25892.716121435165,humanoid-walk,376,ALM
111,1387500,2775000,2775,12.738707879460929,1387500,26125.07855772972,humanoid-walk,376,ALM
112,1400000,2800000,2800,7.266878541400116,1400000,26358.377295970917,humanoid-walk,376,ALM
113,1412500,2825000,2825,3.6109650117748666,1412500,26590.888189077377,humanoid-walk,376,ALM
114,1425000,2850000,2850,7.328403689810675,1425000,26822.201139450073,humanoid-walk,376,ALM
115,1437500,2875000,2875,26.123158228291707,1437500,27053.808725118637,humanoid-walk,376,ALM
116,1450000,2900000,2900,10.935433888953709,1450000,27287.202486753464,humanoid-walk,376,ALM
117,1462500,2925000,2925,88.62604921355737,1462500,27526.40597176552,humanoid-walk,376,ALM
118,1475000,2950000,2950,51.428305748839605,1475000,27756.080589532852,humanoid-walk,376,ALM
119,1487500,2975000,2975,136.96969350351245,1487500,27989.687377929688,humanoid-walk,376,ALM
120,1500000,3000000,3000,1.0144255971160017,1500000,28222.14439845085,humanoid-walk,376,ALM
121,1512500,3025000,3025,86.32390941765871,1512500,28455.009536504745,humanoid-walk,376,ALM
122,1525000,3050000,3050,168.978199212549,1525000,28685.93887424469,humanoid-walk,376,ALM
123,1537500,3075000,3075,125.86855839014387,1537500,28919.504428863525,humanoid-walk,376,ALM
124,1550000,3100000,3100,190.75050105334464,1550000,29151.795824289322,humanoid-walk,376,ALM
125,1562500,3125000,3125,178.05155060729993,1562500,29385.53142929077,humanoid-walk,376,ALM
126,1575000,3150000,3150,93.86070912704938,1575000,29617.76469564438,humanoid-walk,376,ALM
127,1587500,3175000,3175,176.1332231115565,1587500,29850.74196076393,humanoid-walk,376,ALM
128,1600000,3200000,3200,131.04103736336793,1600000,30082.365809202194,humanoid-walk,376,ALM
129,1612500,3225000,3225,159.0270092846461,1612500,30311.76945376396,humanoid-walk,376,ALM
130,1625000,3250000,3250,208.10670169043595,1625000,30549.806171655655,humanoid-walk,376,ALM
131,1637500,3275000,3275,202.80694269683346,1637500,30783.875180482864,humanoid-walk,376,ALM
132,1650000,3300000,3300,171.34850949036186,1650000,31015.766271591187,humanoid-walk,376,ALM
133,1662500,3325000,3325,204.76715799288553,1662500,31247.859713554382,humanoid-walk,376,ALM
134,1675000,3350000,3350,255.85377543235535,1675000,31482.912505865097,humanoid-walk,376,ALM
135,1687500,3375000,3375,279.7612466524448,1687500,31715.075355529785,humanoid-walk,376,ALM
136,1700000,3400000,3400,254.8365255620692,1700000,31947.757346391678,humanoid-walk,376,ALM
137,1712500,3425000,3425,314.1884628203664,1712500,32180.487247943878,humanoid-walk,376,ALM
138,1725000,3450000,3450,287.38162101717734,1725000,32411.77315235138,humanoid-walk,376,ALM
139,1737500,3475000,3475,318.0300845191899,1737500,32645.122205018997,humanoid-walk,376,ALM
140,1750000,3500000,3500,338.7521895417795,1750000,32878.78654932976,humanoid-walk,376,ALM
141,1762500,3525000,3525,330.6411822136257,1762500,33110.096990823746,humanoid-walk,376,ALM
142,1775000,3550000,3550,360.65377481472626,1775000,33341.98494243622,humanoid-walk,376,ALM
143,1787500,3575000,3575,341.68693439794777,1787500,33572.93958616257,humanoid-walk,376,ALM
144,1800000,3600000,3600,342.28989718914363,1800000,33805.05435919762,humanoid-walk,376,ALM
145,1812500,3625000,3625,430.55987907378557,1812500,34035.10798883438,humanoid-walk,376,ALM
146,1825000,3650000,3650,343.93429667536486,1825000,34269.849155426025,humanoid-walk,376,ALM
147,1837500,3675000,3675,513.9180422951179,1837500,34507.5925450325,humanoid-walk,376,ALM
148,1850000,3700000,3700,430.3238792500657,1850000,34739.662291288376,humanoid-walk,376,ALM
149,1862500,3725000,3725,647.8588416012554,1862500,34969.22675156593,humanoid-walk,376,ALM
150,1875000,3750000,3750,592.2791229316447,1875000,35204.32170963287,humanoid-walk,376,ALM
151,1887500,3775000,3775,752.9836848952893,1887500,35438.40202498436,humanoid-walk,376,ALM
152,1900000,3800000,3800,754.175472886823,1900000,35669.85466814041,humanoid-walk,376,ALM
153,1912500,3825000,3825,735.249202616847,1912500,35903.00081348419,humanoid-walk,376,ALM
154,1925000,3850000,3850,792.6195886343819,1925000,36135.21790122986,humanoid-walk,376,ALM
155,1937500,3875000,3875,778.6740928056921,1937500,36367.15085577965,humanoid-walk,376,ALM
156,1950000,3900000,3900,823.693838386825,1950000,36597.33797502518,humanoid-walk,376,ALM
157,1962500,3925000,3925,742.5910675317054,1962500,36831.77471065521,humanoid-walk,376,ALM
158,1975000,3950000,3950,865.0810180099941,1975000,37065.23158121109,humanoid-walk,376,ALM
159,1987500,3975000,3975,851.7087096537109,1987500,37298.88610005379,humanoid-walk,376,ALM
160,2000000,4000000,4000,818.5787800699136,2000000,37528.473439216614,humanoid-walk,376,ALM
161,2012500,4025000,4025,808.6981856501263,2012500,37760.62197828293,humanoid-walk,376,ALM
162,2025000,4050000,4050,807.3170229117924,2025000,37993.4765996933,humanoid-walk,376,ALM
163,2037500,4075000,4075,826.8141444988563,2037500,38225.64834356308,humanoid-walk,376,ALM
164,2050000,4100000,4100,855.8055465904014,2050000,38458.08989405632,humanoid-walk,376,ALM
165,2062500,4125000,4125,784.9895743831614,2062500,38690.99839067459,humanoid-walk,376,ALM
166,2075000,4150000,4150,785.9756192620137,2075000,38924.154971838,humanoid-walk,376,ALM
167,2087500,4175000,4175,849.1185798138107,2087500,39165.06682610512,humanoid-walk,376,ALM
168,2100000,4200000,4200,870.3758147322154,2100000,39394.04590463638,humanoid-walk,376,ALM
169,2112500,4225000,4225,875.6541517775935,2112500,39625.59348988533,humanoid-walk,376,ALM
170,2125000,4250000,4250,877.8735714737804,2125000,39858.37751412392,humanoid-walk,376,ALM
171,2137500,4275000,4275,900.1469605914057,2137500,40090.37911462784,humanoid-walk,376,ALM
172,2150000,4300000,4300,895.8908631762927,2150000,40322.43990063667,humanoid-walk,376,ALM
173,2162500,4325000,4325,876.4912600483773,2162500,40555.507420539856,humanoid-walk,376,ALM
174,2175000,4350000,4350,881.4838531564386,2175000,40787.80281972885,humanoid-walk,376,ALM
175,2187500,4375000,4375,893.90343515669,2187500,41018.97164773941,humanoid-walk,376,ALM
176,2200000,4400000,4400,889.5825675938956,2200000,41252.17641043663,humanoid-walk,376,ALM
177,2212500,4425000,4425,863.2401085938897,2212500,41484.60544753075,humanoid-walk,376,ALM
178,2225000,4450000,4450,872.1580668991119,2225000,41717.46084022522,humanoid-walk,376,ALM
179,2237500,4475000,4475,890.7102111218561,2237500,41947.67636489868,humanoid-walk,376,ALM
180,2250000,4500000,4500,875.9918567757198,2250000,42179.57057881355,humanoid-walk,376,ALM
181,2262500,4525000,4525,904.9503816797554,2262500,42418.8618619442,humanoid-walk,376,ALM
182,2275000,4550000,4550,902.4605605781528,2275000,42651.14238071442,humanoid-walk,376,ALM
183,2287500,4575000,4575,910.8927865980374,2287500,42880.59416604042,humanoid-walk,376,ALM
184,2300000,4600000,4600,913.6721499599125,2300000,43120.35382080078,humanoid-walk,376,ALM
185,2312500,4625000,4625,904.3500183488784,2312500,43354.43944692612,humanoid-walk,376,ALM
186,2325000,4650000,4650,917.6813567481543,2325000,43587.21737265587,humanoid-walk,376,ALM
187,2337500,4675000,4675,868.9398074048304,2337500,43818.419486284256,humanoid-walk,376,ALM
188,2350000,4700000,4700,921.1885989114465,2350000,44050.75680565834,humanoid-walk,376,ALM
189,2362500,4725000,4725,905.3619771043698,2362500,44285.06557941437,humanoid-walk,376,ALM
190,2375000,4750000,4750,892.9164787817015,2375000,44515.60827088356,humanoid-walk,376,ALM
191,2387500,4775000,4775,911.1635308092389,2387500,44745.69044446945,humanoid-walk,376,ALM
192,2400000,4800000,4800,911.6825570107536,2400000,44976.90204310417,humanoid-walk,376,ALM
193,2412500,4825000,4825,914.8252218803893,2412500,45207.51632261276,humanoid-walk,376,ALM
194,2425000,4850000,4850,903.8610666635444,2425000,45438.04030299187,humanoid-walk,376,ALM
195,2437500,4875000,4875,771.2748978948603,2437500,45667.79644727707,humanoid-walk,376,ALM
196,2450000,4900000,4900,772.343379279715,2450000,45899.41235923767,humanoid-walk,376,ALM
197,2462500,4925000,4925,811.7639115324703,2462500,46131.82791352272,humanoid-walk,376,ALM
198,2475000,4950000,4950,895.316217324483,2475000,46362.12447357178,humanoid-walk,376,ALM
199,2487500,4975000,4975,900.5557672952984,2487500,46593.98200273514,humanoid-walk,376,ALM
0,0,0,0,0.9277402502837233,0,16.36975073814392,humanoid-walk,731,ALM
1,12500,25000,25,1.4425755441753516,12500,228.53314685821533,humanoid-walk,731,ALM
2,25000,50000,50,0.8523948791256692,25000,462.90183758735657,humanoid-walk,731,ALM
3,37500,75000,75,1.0677125528705054,37500,689.5661978721619,humanoid-walk,731,ALM
4,50000,100000,100,0.7795984651566659,50000,916.1356329917908,humanoid-walk,731,ALM
5,62500,125000,125,1.2398581874220702,62500,1145.11541223526,humanoid-walk,731,ALM
6,75000,150000,150,0.824836798931025,75000,1376.020956993103,humanoid-walk,731,ALM
7,87500,175000,175,1.0228014002856258,87500,1605.5583891868591,humanoid-walk,731,ALM
8,100000,200000,200,1.3314364496571138,100000,1831.9537680149078,humanoid-walk,731,ALM
9,112500,225000,225,1.0107253822877735,112500,2056.503229856491,humanoid-walk,731,ALM
10,125000,250000,250,1.120172966683691,125000,2281.855632543564,humanoid-walk,731,ALM
11,137500,275000,275,1.2664843149479936,137500,2507.4029054641724,humanoid-walk,731,ALM
12,150000,300000,300,1.5159290258791134,150000,2733.1593046188354,humanoid-walk,731,ALM
13,162500,325000,325,1.435127353478826,162500,2955.9386847019196,humanoid-walk,731,ALM
14,175000,350000,350,1.56006636347508,175000,3178.9647006988525,humanoid-walk,731,ALM
15,187500,375000,375,1.265155371452313,187500,3400.747990131378,humanoid-walk,731,ALM
16,200000,400000,400,1.3189369150147545,200000,3623.9947352409363,humanoid-walk,731,ALM
17,212500,425000,425,1.2502374696438008,212500,3845.954332113266,humanoid-walk,731,ALM
18,225000,450000,450,1.752981793339669,225000,4077.8302607536316,humanoid-walk,731,ALM
19,237500,475000,475,1.0029963671412,237500,4299.88171505928,humanoid-walk,731,ALM
20,250000,500000,500,1.7091807211690924,250000,4522.112245321274,humanoid-walk,731,ALM
21,262500,525000,525,0.9098160456847127,262500,4744.786008358002,humanoid-walk,731,ALM
22,275000,550000,550,1.2778041159420759,275000,4968.205477237701,humanoid-walk,731,ALM
23,287500,575000,575,1.189257794943464,287500,5192.87003493309,humanoid-walk,731,ALM
24,300000,600000,600,1.4499969924081881,300000,5417.20182967186,humanoid-walk,731,ALM
25,312500,625000,625,0.964510855030887,312500,5645.140104055405,humanoid-walk,731,ALM
26,325000,650000,650,1.3270804687707647,325000,5867.784507751465,humanoid-walk,731,ALM
27,337500,675000,675,1.2453334978742416,337500,6090.627472877502,humanoid-walk,731,ALM
28,350000,700000,700,1.2754199253303715,350000,6312.947706460953,humanoid-walk,731,ALM
29,362500,725000,725,1.080581311929291,362500,6535.550560951233,humanoid-walk,731,ALM
30,375000,750000,750,1.193973093205227,375000,6757.606642007828,humanoid-walk,731,ALM
31,387500,775000,775,0.6162856888217123,387500,6979.117912769318,humanoid-walk,731,ALM
32,400000,800000,800,1.469003757447053,400000,7200.059581518173,humanoid-walk,731,ALM
33,412500,825000,825,1.2543555797315433,412500,7421.213252782822,humanoid-walk,731,ALM
34,425000,850000,850,1.1541500420405766,425000,7643.557346343994,humanoid-walk,731,ALM
35,437500,875000,875,1.503774059140477,437500,7865.800206422806,humanoid-walk,731,ALM
36,450000,900000,900,1.3671285960460093,450000,8087.269310474396,humanoid-walk,731,ALM
37,462500,925000,925,1.4076667352287238,462500,8309.329503774643,humanoid-walk,731,ALM
38,475000,950000,950,1.0281709652470474,475000,8531.392491340637,humanoid-walk,731,ALM
39,487500,975000,975,1.0078809158399236,487500,8753.913397312164,humanoid-walk,731,ALM
40,500000,1000000,1000,2.167013647531234,500000,8982.171053647995,humanoid-walk,731,ALM
41,512500,1025000,1025,1.90911472862105,512500,9202.921822786331,humanoid-walk,731,ALM
42,525000,1050000,1050,1.5896935150567315,525000,9423.692630052567,humanoid-walk,731,ALM
43,537500,1075000,1075,1.2872735844066514,537500,9645.741276979446,humanoid-walk,731,ALM
44,550000,1100000,1100,1.2130416071138823,550000,9867.764870882034,humanoid-walk,731,ALM
45,562500,1125000,1125,1.4029971940615371,562500,10088.927933454514,humanoid-walk,731,ALM
46,575000,1150000,1150,1.8870157332096125,575000,10310.53331542015,humanoid-walk,731,ALM
47,587500,1175000,1175,1.626911991843362,587500,10531.269421339035,humanoid-walk,731,ALM
48,600000,1200000,1200,1.43135793141657,600000,10752.870239019394,humanoid-walk,731,ALM
49,612500,1225000,1225,2.621404336452066,612500,10974.862315177917,humanoid-walk,731,ALM
50,625000,1250000,1250,1.2861964813030489,625000,11197.12993478775,humanoid-walk,731,ALM
51,637500,1275000,1275,1.1779560961411362,637500,11420.096718072891,humanoid-walk,731,ALM
52,650000,1300000,1300,0.9493313270130159,650000,11642.651792049408,humanoid-walk,731,ALM
53,662500,1325000,1325,2.606024504245334,662500,11863.525925159454,humanoid-walk,731,ALM
54,675000,1350000,1350,1.797157218489397,675000,12085.460426568985,humanoid-walk,731,ALM
55,687500,1375000,1375,2.03260530223036,687500,12308.234795331955,humanoid-walk,731,ALM
56,700000,1400000,1400,1.7203242976990196,700000,12529.951008081436,humanoid-walk,731,ALM
57,712500,1425000,1425,2.467885613681653,712500,12755.500694036484,humanoid-walk,731,ALM
58,725000,1450000,1450,1.7741639089630081,725000,12976.740799427032,humanoid-walk,731,ALM
59,737500,1475000,1475,1.2703529888420877,737500,13198.135784626007,humanoid-walk,731,ALM
60,750000,1500000,1500,2.6098344361802006,750000,13418.737578630447,humanoid-walk,731,ALM
61,762500,1525000,1525,1.4113253487862125,762500,13638.958013057709,humanoid-walk,731,ALM
62,775000,1550000,1550,2.927588559068814,775000,13861.2131357193,humanoid-walk,731,ALM
63,787500,1575000,1575,1.1956963542882038,787500,14083.551589488983,humanoid-walk,731,ALM
64,800000,1600000,1600,0.9915664267069149,800000,14305.815130233765,humanoid-walk,731,ALM
65,812500,1625000,1625,1.4766843334817978,812500,14527.373044967651,humanoid-walk,731,ALM
66,825000,1650000,1650,1.601209303626567,825000,14749.024367332458,humanoid-walk,731,ALM
67,837500,1675000,1675,1.242948630994515,837500,14970.628405094147,humanoid-walk,731,ALM
68,850000,1700000,1700,1.4312387680575607,850000,15196.950015306473,humanoid-walk,731,ALM
69,862500,1725000,1725,0.8705595492267625,862500,15420.131591796875,humanoid-walk,731,ALM
70,875000,1750000,1750,2.5919748249049226,875000,15641.141720056534,humanoid-walk,731,ALM
71,887500,1775000,1775,1.6414574020111634,887500,15862.727244615555,humanoid-walk,731,ALM
72,900000,1800000,1800,2.328728922327181,900000,16085.331011295319,humanoid-walk,731,ALM
73,912500,1825000,1825,1.3095996773598444,912500,16308.294069290161,humanoid-walk,731,ALM
74,925000,1850000,1850,1.2512121383733406,925000,16531.086071252823,humanoid-walk,731,ALM
75,937500,1875000,1875,2.2713616668841836,937500,16754.371780872345,humanoid-walk,731,ALM
76,950000,1900000,1900,2.131566981145718,950000,16976.610653162003,humanoid-walk,731,ALM
77,962500,1925000,1925,1.8678970243610382,962500,17199.279942512512,humanoid-walk,731,ALM
78,975000,1950000,1950,1.4860872941713696,975000,17421.617383480072,humanoid-walk,731,ALM
79,987500,1975000,1975,4.803424752858762,987500,17643.90269422531,humanoid-walk,731,ALM
80,1000000,2000000,2000,3.0320069270682692,1000000,17867.346747398376,humanoid-walk,731,ALM
81,1012500,2025000,2025,2.7619512042939585,1012500,18090.679955482483,humanoid-walk,731,ALM
82,1025000,2050000,2050,1.0950293384997378,1025000,18314.48844718933,humanoid-walk,731,ALM
83,1037500,2075000,2075,1.170654880773161,1037500,18538.785235881805,humanoid-walk,731,ALM
84,1050000,2100000,2100,1.427241785906531,1050000,18762.247742652893,humanoid-walk,731,ALM
85,1062500,2125000,2125,1.2266914135848428,1062500,18984.96257996559,humanoid-walk,731,ALM
86,1075000,2150000,2150,2.207280254633532,1075000,19212.87026143074,humanoid-walk,731,ALM
87,1087500,2175000,2175,0.925138411242254,1087500,19435.650795936584,humanoid-walk,731,ALM
88,1100000,2200000,2200,1.1864323138519317,1100000,19657.599392175674,humanoid-walk,731,ALM
89,1112500,2225000,2225,1.6272207929097011,1112500,19879.184359788895,humanoid-walk,731,ALM
90,1125000,2250000,2250,1.5550293309798353,1125000,20106.936891317368,humanoid-walk,731,ALM
91,1137500,2275000,2275,1.263991491665807,1137500,20330.884637355804,humanoid-walk,731,ALM
92,1150000,2300000,2300,3.1806047687879433,1150000,20553.876492023468,humanoid-walk,731,ALM
93,1162500,2325000,2325,1.0785811250119661,1162500,20775.261603593826,humanoid-walk,731,ALM
94,1175000,2350000,2350,1.7269545043797172,1175000,20998.55814933777,humanoid-walk,731,ALM
95,1187500,2375000,2375,2.188651818280687,1187500,21222.095173835754,humanoid-walk,731,ALM
96,1200000,2400000,2400,2.450991809256874,1200000,21442.883132457733,humanoid-walk,731,ALM
97,1212500,2425000,2425,0.9006463772375858,1212500,21665.860445261,humanoid-walk,731,ALM
98,1225000,2450000,2450,1.4580227053083707,1225000,21889.94734621048,humanoid-walk,731,ALM
99,1237500,2475000,2475,0.9304121837987896,1237500,22114.56261587143,humanoid-walk,731,ALM
100,1250000,2500000,2500,1.7032232974630463,1250000,22337.788275957108,humanoid-walk,731,ALM
101,1262500,2525000,2525,1.0658827643836877,1262500,22562.009254455566,humanoid-walk,731,ALM
102,1275000,2550000,2550,0.9323495467648331,1275000,22787.07572054863,humanoid-walk,731,ALM
103,1287500,2575000,2575,5.862891147136662,1287500,23014.41095805168,humanoid-walk,731,ALM
104,1300000,2600000,2600,1.9184984552427722,1300000,23238.49895787239,humanoid-walk,731,ALM
105,1312500,2625000,2625,1.161053875434008,1312500,23461.273208856583,humanoid-walk,731,ALM
106,1325000,2650000,2650,1.802749981226124,1325000,23683.894416570663,humanoid-walk,731,ALM
107,1337500,2675000,2675,2.727795803632541,1337500,23910.545326709747,humanoid-walk,731,ALM
108,1350000,2700000,2700,2.430029680916264,1350000,24133.14788365364,humanoid-walk,731,ALM
109,1362500,2725000,2725,2.3988453713098608,1362500,24356.0753800869,humanoid-walk,731,ALM
110,1375000,2750000,2750,0.8775436584849974,1375000,24578.510615348816,humanoid-walk,731,ALM
111,1387500,2775000,2775,5.296480655871531,1387500,24802.669970989227,humanoid-walk,731,ALM
112,1400000,2800000,2800,0.9416646541480066,1400000,25026.775117635727,humanoid-walk,731,ALM
113,1412500,2825000,2825,1.13397533323493,1412500,25250.378736257553,humanoid-walk,731,ALM
114,1425000,2850000,2850,1.3950737129390578,1425000,25483.875209331512,humanoid-walk,731,ALM
115,1437500,2875000,2875,4.191377136414574,1437500,25707.51175904274,humanoid-walk,731,ALM
116,1450000,2900000,2900,1.5584815959674327,1450000,25931.208315372467,humanoid-walk,731,ALM
117,1462500,2925000,2925,1.3128069550152337,1462500,26156.021641731262,humanoid-walk,731,ALM
118,1475000,2950000,2950,1.2643502180016655,1475000,26381.222349643707,humanoid-walk,731,ALM
119,1487500,2975000,2975,0.6024288728064374,1487500,26605.05480980873,humanoid-walk,731,ALM
120,1500000,3000000,3000,2.5538736324644327,1500000,26827.227340459824,humanoid-walk,731,ALM
121,1512500,3025000,3025,1.5766137390843897,1512500,27049.634650468826,humanoid-walk,731,ALM
122,1525000,3050000,3050,1.0079262341493997,1525000,27272.78283548355,humanoid-walk,731,ALM
123,1537500,3075000,3075,1.5789288574470066,1537500,27497.262228250504,humanoid-walk,731,ALM
124,1550000,3100000,3100,5.04793247603846,1550000,27722.036548376083,humanoid-walk,731,ALM
125,1562500,3125000,3125,1.2241993924285572,1562500,27945.544781446457,humanoid-walk,731,ALM
126,1575000,3150000,3150,2.021699580034589,1575000,28168.345336914062,humanoid-walk,731,ALM
127,1587500,3175000,3175,2.4342204708047857,1587500,28393.35836315155,humanoid-walk,731,ALM
128,1600000,3200000,3200,1.3919724401943752,1600000,28615.714158773422,humanoid-walk,731,ALM
129,1612500,3225000,3225,1.2650986215818714,1612500,28841.012409210205,humanoid-walk,731,ALM
130,1625000,3250000,3250,2.920330157320257,1625000,29063.783136844635,humanoid-walk,731,ALM
131,1637500,3275000,3275,1.872639832687738,1637500,29287.08689546585,humanoid-walk,731,ALM
132,1650000,3300000,3300,1.8675307591359314,1650000,29514.454025745392,humanoid-walk,731,ALM
133,1662500,3325000,3325,1.1564432190948049,1662500,29737.215206623077,humanoid-walk,731,ALM
134,1675000,3350000,3350,0.9644571552125566,1675000,29959.895758390427,humanoid-walk,731,ALM
135,1687500,3375000,3375,1.0787117828149544,1687500,30182.88965654373,humanoid-walk,731,ALM
136,1700000,3400000,3400,1.4536032255098976,1700000,30405.898287057877,humanoid-walk,731,ALM
137,1712500,3425000,3425,1.2761874478806297,1712500,30627.870416402817,humanoid-walk,731,ALM
138,1725000,3450000,3450,1.6646115022235246,1725000,30850.36944913864,humanoid-walk,731,ALM
139,1737500,3475000,3475,0.890654299149735,1737500,31071.673271656036,humanoid-walk,731,ALM
140,1750000,3500000,3500,0.9240544968004375,1750000,31292.656113147736,humanoid-walk,731,ALM
141,1762500,3525000,3525,5.290930799832032,1762500,31515.343789815903,humanoid-walk,731,ALM
142,1775000,3550000,3550,1.3602327163815617,1775000,31737.662249326706,humanoid-walk,731,ALM
143,1787500,3575000,3575,2.539900371143072,1787500,31959.507086753845,humanoid-walk,731,ALM
144,1800000,3600000,3600,2.0807784795285627,1800000,32182.085525274277,humanoid-walk,731,ALM
145,1812500,3625000,3625,1.448435002369509,1812500,32403.583313941956,humanoid-walk,731,ALM
146,1825000,3650000,3650,1.2411723596914652,1825000,32624.618759393692,humanoid-walk,731,ALM
147,1837500,3675000,3675,3.7605598084495817,1837500,32845.045530080795,humanoid-walk,731,ALM
148,1850000,3700000,3700,0.9286223387116961,1850000,33067.465525627136,humanoid-walk,731,ALM
149,1862500,3725000,3725,1.1899535293366106,1862500,33301.13353443146,humanoid-walk,731,ALM
150,1875000,3750000,3750,1.5173049658324356,1875000,33522.97923922539,humanoid-walk,731,ALM
151,1887500,3775000,3775,1.074567200428841,1887500,33744.87082409859,humanoid-walk,731,ALM
152,1900000,3800000,3800,4.071963907061985,1900000,33966.7684636116,humanoid-walk,731,ALM
153,1912500,3825000,3825,3.2537036098133156,1912500,34188.852311849594,humanoid-walk,731,ALM
154,1925000,3850000,3850,1.2553640290975168,1925000,34410.27647256851,humanoid-walk,731,ALM
155,1937500,3875000,3875,3.111566018016038,1937500,34631.704703092575,humanoid-walk,731,ALM
156,1950000,3900000,3900,0.9112591996269981,1950000,34853.5348572731,humanoid-walk,731,ALM
157,1962500,3925000,3925,1.1374917613353488,1962500,35075.46463274956,humanoid-walk,731,ALM
158,1975000,3950000,3950,2.46578818200516,1975000,35297.65157675743,humanoid-walk,731,ALM
159,1987500,3975000,3975,1.0087500773616678,1987500,35520.35286474228,humanoid-walk,731,ALM
160,2000000,4000000,4000,2.1927103411975954,2000000,35743.19638180733,humanoid-walk,731,ALM
161,2012500,4025000,4025,1.5364062949786548,2012500,35966.108264923096,humanoid-walk,731,ALM
162,2025000,4050000,4050,1.6153510906632502,2025000,36188.96520972252,humanoid-walk,731,ALM
163,2037500,4075000,4075,1.689065984447024,2037500,36411.43794584274,humanoid-walk,731,ALM
164,2050000,4100000,4100,2.6086697079022594,2050000,36631.4921336174,humanoid-walk,731,ALM
165,2062500,4125000,4125,2.418139647391164,2062500,36852.39981842041,humanoid-walk,731,ALM
166,2075000,4150000,4150,1.3027452886095454,2075000,37075.030232429504,humanoid-walk,731,ALM
167,2087500,4175000,4175,3.7597534268012183,2087500,37305.81983280182,humanoid-walk,731,ALM
168,2100000,4200000,4200,1.202721074965964,2100000,37527.814722299576,humanoid-walk,731,ALM
169,2112500,4225000,4225,0.8593994365006681,2112500,37750.06166481972,humanoid-walk,731,ALM
170,2125000,4250000,4250,4.737059869936325,2125000,37972.76392698288,humanoid-walk,731,ALM
171,2137500,4275000,4275,1.8084454267315988,2137500,38195.53674244881,humanoid-walk,731,ALM
172,2150000,4300000,4300,3.3219171228491953,2150000,38417.06523799896,humanoid-walk,731,ALM
173,2162500,4325000,4325,1.7084929274539284,2162500,38638.433280706406,humanoid-walk,731,ALM
174,2175000,4350000,4350,1.8328338936688788,2175000,38860.92008161545,humanoid-walk,731,ALM
175,2187500,4375000,4375,2.4369755620275617,2187500,39083.03117322922,humanoid-walk,731,ALM
176,2200000,4400000,4400,2.1124432040737515,2200000,39305.30864572525,humanoid-walk,731,ALM
177,2212500,4425000,4425,2.491617780814474,2212500,39527.50741934776,humanoid-walk,731,ALM
178,2225000,4450000,4450,1.1730076932890063,2225000,39750.44133067131,humanoid-walk,731,ALM
179,2237500,4475000,4475,1.1427171676245105,2237500,39972.97595691681,humanoid-walk,731,ALM
180,2250000,4500000,4500,2.8045708844404778,2250000,40195.21241593361,humanoid-walk,731,ALM
181,2262500,4525000,4525,1.3083827200349232,2262500,40417.754890441895,humanoid-walk,731,ALM
182,2275000,4550000,4550,1.3902597090288167,2275000,40640.49556994438,humanoid-walk,731,ALM
183,2287500,4575000,4575,2.4469810897923194,2287500,40863.25744056702,humanoid-walk,731,ALM
184,2300000,4600000,4600,1.895204958895927,2300000,41090.23234820366,humanoid-walk,731,ALM
185,2312500,4625000,4625,1.486613291829562,2312500,41315.23472547531,humanoid-walk,731,ALM
186,2325000,4650000,4650,1.1514383085547748,2325000,41537.28979206085,humanoid-walk,731,ALM
187,2337500,4675000,4675,0.7460220176752921,2337500,41760.18511104584,humanoid-walk,731,ALM
188,2350000,4700000,4700,0.6131026705880886,2350000,41982.43342041969,humanoid-walk,731,ALM
189,2362500,4725000,4725,2.202021481819933,2362500,42205.4681084156,humanoid-walk,731,ALM
190,2375000,4750000,4750,1.0935393433613,2375000,42428.439531326294,humanoid-walk,731,ALM
191,2387500,4775000,4775,7.530466718041964,2387500,42650.31275558472,humanoid-walk,731,ALM
192,2400000,4800000,4800,0.8861540338444405,2400000,42871.58427596092,humanoid-walk,731,ALM
193,2412500,4825000,4825,0.8723948293877333,2412500,43093.91411423683,humanoid-walk,731,ALM
194,2425000,4850000,4850,3.1707196188752964,2425000,43317.34130358696,humanoid-walk,731,ALM
195,2437500,4875000,4875,2.6380390343550135,2437500,43540.28288722038,humanoid-walk,731,ALM
196,2450000,4900000,4900,4.357883152474658,2450000,43763.39951658249,humanoid-walk,731,ALM
197,2462500,4925000,4925,3.235855175788429,2462500,43986.13007450104,humanoid-walk,731,ALM
198,2475000,4950000,4950,2.8807959352485044,2475000,44209.20072412491,humanoid-walk,731,ALM
199,2487500,4975000,4975,1.3539356974253198,2487500,44432.2267305851,humanoid-walk,731,ALM
0,0,0,0,0.5753666880086243,0,16.567402362823486,humanoid-walk,818,ALM
1,12500,25000,25,1.2907034401702304,12500,237.30026841163635,humanoid-walk,818,ALM
2,25000,50000,50,1.2938177188234963,25000,476.313294172287,humanoid-walk,818,ALM
3,37500,75000,75,1.456656437242064,37500,713.5887162685394,humanoid-walk,818,ALM
4,50000,100000,100,1.4555031302809094,50000,952.0517053604126,humanoid-walk,818,ALM
5,62500,125000,125,1.4963257500090232,62500,1189.180419921875,humanoid-walk,818,ALM
6,75000,150000,150,0.9123147561594882,75000,1425.3363001346588,humanoid-walk,818,ALM
7,87500,175000,175,1.1983454104584388,87500,1661.86759018898,humanoid-walk,818,ALM
8,100000,200000,200,1.5424487433394112,100000,1901.6645574569702,humanoid-walk,818,ALM
9,112500,225000,225,1.4677223050617187,112500,2140.2352561950684,humanoid-walk,818,ALM
10,125000,250000,250,1.5549193315870247,125000,2380.6820175647736,humanoid-walk,818,ALM
11,137500,275000,275,1.39381262760642,137500,2618.2403044700623,humanoid-walk,818,ALM
12,150000,300000,300,1.3451420222667516,150000,2855.3540914058685,humanoid-walk,818,ALM
13,162500,325000,325,1.162009932107408,162500,3093.0191173553467,humanoid-walk,818,ALM
14,175000,350000,350,1.769116460120206,175000,3331.711407661438,humanoid-walk,818,ALM
15,187500,375000,375,1.1919919652985005,187500,3570.1197488307953,humanoid-walk,818,ALM
16,200000,400000,400,2.0088503349418625,200000,3808.8750054836273,humanoid-walk,818,ALM
17,212500,425000,425,1.334276509960631,212500,4051.6713633537292,humanoid-walk,818,ALM
18,225000,450000,450,1.2858140772262103,225000,4289.495689630508,humanoid-walk,818,ALM
19,237500,475000,475,1.3735149759455016,237500,4529.587450504303,humanoid-walk,818,ALM
20,250000,500000,500,1.6491743273220059,250000,4768.130362272263,humanoid-walk,818,ALM
21,262500,525000,525,1.305506204940239,262500,5007.0944211483,humanoid-walk,818,ALM
22,275000,550000,550,1.4567968642110045,275000,5246.3035480976105,humanoid-walk,818,ALM
23,287500,575000,575,1.146951348312259,287500,5485.04983663559,humanoid-walk,818,ALM
24,300000,600000,600,1.4082314618688632,300000,5721.6983432769775,humanoid-walk,818,ALM
25,312500,625000,625,1.1638971360826165,312500,5961.582893133163,humanoid-walk,818,ALM
26,325000,650000,650,1.0209878381515238,325000,6202.0798370838165,humanoid-walk,818,ALM
27,337500,675000,675,0.8782147343340287,337500,6440.414796113968,humanoid-walk,818,ALM
28,350000,700000,700,2.0168116487951186,350000,6677.097574710846,humanoid-walk,818,ALM
29,362500,725000,725,1.9521966136171762,362500,6911.876399755478,humanoid-walk,818,ALM
30,375000,750000,750,1.6548023488654942,375000,7149.906373500824,humanoid-walk,818,ALM
31,387500,775000,775,0.9732069522099815,387500,7385.722279310226,humanoid-walk,818,ALM
32,400000,800000,800,1.6828760179610387,400000,7622.177508354187,humanoid-walk,818,ALM
33,412500,825000,825,0.892169801923551,412500,7859.219509124756,humanoid-walk,818,ALM
34,425000,850000,850,1.919196893998787,425000,8099.73407793045,humanoid-walk,818,ALM
35,437500,875000,875,1.1490040544954805,437500,8339.314305067062,humanoid-walk,818,ALM
36,450000,900000,900,3.0320091539363263,450000,8578.931679964066,humanoid-walk,818,ALM
37,462500,925000,925,0.9949921809411706,462500,8817.913691520691,humanoid-walk,818,ALM
38,475000,950000,950,4.329114999270577,475000,9053.488276481628,humanoid-walk,818,ALM
39,487500,975000,975,2.49028316789489,487500,9290.543221712112,humanoid-walk,818,ALM
40,500000,1000000,1000,1.1380076736750169,500000,9526.79654097557,humanoid-walk,818,ALM
41,512500,1025000,1025,1.2324995940627042,512500,9765.834495782852,humanoid-walk,818,ALM
42,525000,1050000,1050,1.1706548911452312,525000,10005.218826770782,humanoid-walk,818,ALM
43,537500,1075000,1075,1.7843573593371413,537500,10243.62769126892,humanoid-walk,818,ALM
44,550000,1100000,1100,2.7917710549163344,550000,10483.695673465729,humanoid-walk,818,ALM
45,562500,1125000,1125,2.2250434049216645,562500,10719.647954702377,humanoid-walk,818,ALM
46,575000,1150000,1150,2.8706636223054622,575000,10953.717426776886,humanoid-walk,818,ALM
47,587500,1175000,1175,3.24737675891514,587500,11190.915832042694,humanoid-walk,818,ALM
48,600000,1200000,1200,1.6791957129953894,600000,11427.135701656342,humanoid-walk,818,ALM
49,612500,1225000,1225,1.0742946693095357,612500,11666.648540735245,humanoid-walk,818,ALM
50,625000,1250000,1250,1.4206206224040163,625000,11907.33631849289,humanoid-walk,818,ALM
51,637500,1275000,1275,1.0761588314200403,637500,12143.289245128632,humanoid-walk,818,ALM
52,650000,1300000,1300,2.7428160741760323,650000,12380.575504302979,humanoid-walk,818,ALM
53,662500,1325000,1325,4.418740769637164,662500,12617.286809206009,humanoid-walk,818,ALM
54,675000,1350000,1350,2.3780551971626847,675000,12854.479107379913,humanoid-walk,818,ALM
55,687500,1375000,1375,2.287749958675133,687500,13110.46607017517,humanoid-walk,818,ALM
56,700000,1400000,1400,1.5182974477451034,700000,13347.898506879807,humanoid-walk,818,ALM
57,712500,1425000,1425,0.8501206013843119,712500,13585.541014909744,humanoid-walk,818,ALM
58,725000,1450000,1450,2.1379451725586383,725000,13823.980143070221,humanoid-walk,818,ALM
59,737500,1475000,1475,2.1023824953901746,737500,14062.6401617527,humanoid-walk,818,ALM
60,750000,1500000,1500,3.0468096386395134,750000,14301.761627435684,humanoid-walk,818,ALM
61,762500,1525000,1525,2.24735824958368,762500,14542.648386001587,humanoid-walk,818,ALM
62,775000,1550000,1550,1.5862991926728613,775000,14780.887784004211,humanoid-walk,818,ALM
63,787500,1575000,1575,3.167242634440964,787500,15019.731035709381,humanoid-walk,818,ALM
64,800000,1600000,1600,2.9909804909668,800000,15256.969491481781,humanoid-walk,818,ALM
65,812500,1625000,1625,5.174305949900759,812500,15493.95251584053,humanoid-walk,818,ALM
66,825000,1650000,1650,3.3462065235586493,825000,15738.074947357178,humanoid-walk,818,ALM
67,837500,1675000,1675,2.1385327694783673,837500,15976.707706689835,humanoid-walk,818,ALM
68,850000,1700000,1700,4.109887538795459,850000,16212.47986292839,humanoid-walk,818,ALM
69,862500,1725000,1725,1.8282180689356995,862500,16448.896866559982,humanoid-walk,818,ALM
70,875000,1750000,1750,5.583418537129058,875000,16685.427392721176,humanoid-walk,818,ALM
71,887500,1775000,1775,3.7219302010839357,887500,16925.178701400757,humanoid-walk,818,ALM
72,900000,1800000,1800,2.665238325895428,900000,17161.692150354385,humanoid-walk,818,ALM
73,912500,1825000,1825,4.5459938686915375,912500,17399.118808031082,humanoid-walk,818,ALM
74,925000,1850000,1850,5.000863768932936,925000,17637.088443756104,humanoid-walk,818,ALM
75,937500,1875000,1875,1.3367168344423432,937500,17878.027097702026,humanoid-walk,818,ALM
76,950000,1900000,1900,2.44045451952485,950000,18116.014892578125,humanoid-walk,818,ALM
77,962500,1925000,1925,4.252824875038684,962500,18353.004327774048,humanoid-walk,818,ALM
78,975000,1950000,1950,1.0322607005983977,975000,18591.539045333862,humanoid-walk,818,ALM
79,987500,1975000,1975,3.5161235552367684,987500,18829.320249795914,humanoid-walk,818,ALM
80,1000000,2000000,2000,6.419756300959882,1000000,19068.14397597313,humanoid-walk,818,ALM
81,1012500,2025000,2025,6.094845402820001,1012500,19303.969488859177,humanoid-walk,818,ALM
82,1025000,2050000,2050,14.945691543614492,1025000,19540.569400310516,humanoid-walk,818,ALM
83,1037500,2075000,2075,2.090777829018167,1037500,19780.240818738937,humanoid-walk,818,ALM
84,1050000,2100000,2100,18.834787936856134,1050000,20019.41409945488,humanoid-walk,818,ALM
85,1062500,2125000,2125,20.610125530414958,1062500,20255.447727441788,humanoid-walk,818,ALM
86,1075000,2150000,2150,14.92579573526757,1075000,20493.40775203705,humanoid-walk,818,ALM
87,1087500,2175000,2175,36.73851418873046,1087500,20731.979266881943,humanoid-walk,818,ALM
88,1100000,2200000,2200,103.53680779811734,1100000,20969.72102689743,humanoid-walk,818,ALM
89,1112500,2225000,2225,148.06139864084736,1112500,21209.246591567993,humanoid-walk,818,ALM
90,1125000,2250000,2250,106.20965071642338,1125000,21446.541986465454,humanoid-walk,818,ALM
91,1137500,2275000,2275,2.8495452997815605,1137500,21683.217129468918,humanoid-walk,818,ALM
92,1150000,2300000,2300,58.40950971499086,1150000,21921.873487234116,humanoid-walk,818,ALM
93,1162500,2325000,2325,165.58590775858153,1162500,22161.21658039093,humanoid-walk,818,ALM
94,1175000,2350000,2350,184.63186833535735,1175000,22398.08150458336,humanoid-walk,818,ALM
95,1187500,2375000,2375,183.49753251860568,1187500,22638.23311328888,humanoid-walk,818,ALM
96,1200000,2400000,2400,150.97820917782033,1200000,22880.96898293495,humanoid-walk,818,ALM
97,1212500,2425000,2425,189.27327242472396,1212500,23120.1284096241,humanoid-walk,818,ALM
98,1225000,2450000,2450,202.9120279243429,1225000,23359.386342287064,humanoid-walk,818,ALM
99,1237500,2475000,2475,241.66783032354402,1237500,23597.532518148422,humanoid-walk,818,ALM
100,1250000,2500000,2500,185.01308331028903,1250000,23842.212073802948,humanoid-walk,818,ALM
101,1262500,2525000,2525,218.95553266501256,1262500,24082.2518157959,humanoid-walk,818,ALM
102,1275000,2550000,2550,181.25852047822377,1275000,24322.11870121956,humanoid-walk,818,ALM
103,1287500,2575000,2575,166.33340041435395,1287500,24557.434037446976,humanoid-walk,818,ALM
104,1300000,2600000,2600,132.54421415334747,1300000,24795.741983175278,humanoid-walk,818,ALM
105,1312500,2625000,2625,257.10448206203125,1312500,25035.899661302567,humanoid-walk,818,ALM
106,1325000,2650000,2650,325.4491865187612,1325000,25274.27089190483,humanoid-walk,818,ALM
107,1337500,2675000,2675,284.5386746881215,1337500,25509.80450797081,humanoid-walk,818,ALM
108,1350000,2700000,2700,279.07067049035993,1350000,25751.628340005875,humanoid-walk,818,ALM
109,1362500,2725000,2725,298.81580146973687,1362500,25988.423979997635,humanoid-walk,818,ALM
110,1375000,2750000,2750,270.20364108483807,1375000,26228.458912849426,humanoid-walk,818,ALM
111,1387500,2775000,2775,366.08643277116073,1387500,26471.047676563263,humanoid-walk,818,ALM
112,1400000,2800000,2800,359.66712990088035,1400000,26709.19324684143,humanoid-walk,818,ALM
113,1412500,2825000,2825,378.7479428616503,1412500,26947.13795351982,humanoid-walk,818,ALM
114,1425000,2850000,2850,439.694344429293,1425000,27186.662794589996,humanoid-walk,818,ALM
115,1437500,2875000,2875,479.5790807490028,1437500,27430.913054943085,humanoid-walk,818,ALM
116,1450000,2900000,2900,544.1081637821519,1450000,27667.677750349045,humanoid-walk,818,ALM
117,1462500,2925000,2925,656.3234645375662,1462500,27908.49981570244,humanoid-walk,818,ALM
118,1475000,2950000,2950,675.6899477020321,1475000,28146.965789556503,humanoid-walk,818,ALM
119,1487500,2975000,2975,604.7541929004427,1487500,28385.905351161957,humanoid-walk,818,ALM
120,1500000,3000000,3000,731.7392029996954,1500000,28623.34492444992,humanoid-walk,818,ALM
121,1512500,3025000,3025,651.4618243553543,1512500,28859.43071126938,humanoid-walk,818,ALM
122,1525000,3050000,3050,736.0868733832787,1525000,29095.598749637604,humanoid-walk,818,ALM
123,1537500,3075000,3075,782.8843773708815,1537500,29332.75730395317,humanoid-walk,818,ALM
124,1550000,3100000,3100,530.2166225129579,1550000,29573.725004196167,humanoid-walk,818,ALM
125,1562500,3125000,3125,566.4126568286206,1562500,29807.726999521255,humanoid-walk,818,ALM
126,1575000,3150000,3150,636.0567353565979,1575000,30054.07604455948,humanoid-walk,818,ALM
127,1587500,3175000,3175,742.8137984848992,1587500,30292.450180768967,humanoid-walk,818,ALM
128,1600000,3200000,3200,810.1778834668406,1600000,30530.787848234177,humanoid-walk,818,ALM
129,1612500,3225000,3225,838.1099742532931,1612500,30766.53426718712,humanoid-walk,818,ALM
130,1625000,3250000,3250,630.0980478161237,1625000,31005.346793174744,humanoid-walk,818,ALM
131,1637500,3275000,3275,840.8175226974887,1637500,31245.34834265709,humanoid-walk,818,ALM
132,1650000,3300000,3300,844.6825751893996,1650000,31485.384009838104,humanoid-walk,818,ALM
133,1662500,3325000,3325,853.7590429619584,1662500,31722.440726041794,humanoid-walk,818,ALM
134,1675000,3350000,3350,826.9234405709021,1675000,31963.415316581726,humanoid-walk,818,ALM
135,1687500,3375000,3375,829.1454936296537,1687500,32200.71391749382,humanoid-walk,818,ALM
136,1700000,3400000,3400,854.8246364515071,1700000,32440.531326055527,humanoid-walk,818,ALM
137,1712500,3425000,3425,860.4840110806861,1712500,32676.431027412415,humanoid-walk,818,ALM
138,1725000,3450000,3450,860.3191738673606,1725000,32912.047938108444,humanoid-walk,818,ALM
139,1737500,3475000,3475,867.7210739350492,1737500,33151.32325720787,humanoid-walk,818,ALM
140,1750000,3500000,3500,878.7441360580087,1750000,33390.23856639862,humanoid-walk,818,ALM
141,1762500,3525000,3525,863.121177364557,1762500,33630.89714741707,humanoid-walk,818,ALM
142,1775000,3550000,3550,874.1270248081182,1775000,33866.7539434433,humanoid-walk,818,ALM
143,1787500,3575000,3575,878.2905064020827,1787500,34104.27208018303,humanoid-walk,818,ALM
144,1800000,3600000,3600,880.4774138880248,1800000,34341.75156903267,humanoid-walk,818,ALM
145,1812500,3625000,3625,850.8040656745419,1812500,34581.55821156502,humanoid-walk,818,ALM
146,1825000,3650000,3650,846.3697043982871,1825000,34819.91439628601,humanoid-walk,818,ALM
147,1837500,3675000,3675,805.2295819194374,1837500,35055.22471690178,humanoid-walk,818,ALM
148,1850000,3700000,3700,828.4655646136246,1850000,35293.011722803116,humanoid-walk,818,ALM
149,1862500,3725000,3725,845.3359595406462,1862500,35531.61308813095,humanoid-walk,818,ALM
150,1875000,3750000,3750,888.54089553695,1875000,35769.55694437027,humanoid-walk,818,ALM
151,1887500,3775000,3775,865.672670764375,1887500,36005.45368170738,humanoid-walk,818,ALM
152,1900000,3800000,3800,836.329616711703,1900000,36244.964497089386,humanoid-walk,818,ALM
153,1912500,3825000,3825,825.1587556614952,1912500,36483.0493555069,humanoid-walk,818,ALM
154,1925000,3850000,3850,822.162624803146,1925000,36723.40421485901,humanoid-walk,818,ALM
155,1937500,3875000,3875,872.0299858690847,1937500,36960.2426469326,humanoid-walk,818,ALM
156,1950000,3900000,3900,889.9354775757338,1950000,37198.722646951675,humanoid-walk,818,ALM
157,1962500,3925000,3925,858.1674427565965,1962500,37438.87639427185,humanoid-walk,818,ALM
158,1975000,3950000,3950,896.1714587753543,1975000,37676.4638364315,humanoid-walk,818,ALM
159,1987500,3975000,3975,907.8734678908837,1987500,37913.8087413311,humanoid-walk,818,ALM
160,2000000,4000000,4000,895.4871877587709,2000000,38151.40114617348,humanoid-walk,818,ALM
161,2012500,4025000,4025,890.5510935396724,2012500,38390.83611226082,humanoid-walk,818,ALM
162,2025000,4050000,4050,900.8729545482595,2025000,38628.6982088089,humanoid-walk,818,ALM
163,2037500,4075000,4075,881.9381250454986,2037500,38867.762972831726,humanoid-walk,818,ALM
164,2050000,4100000,4100,870.7300386410113,2050000,39105.55370593071,humanoid-walk,818,ALM
165,2062500,4125000,4125,799.1256528697986,2062500,39342.33976840973,humanoid-walk,818,ALM
166,2075000,4150000,4150,878.8079574511576,2075000,39580.815999507904,humanoid-walk,818,ALM
167,2087500,4175000,4175,795.4407435486899,2087500,39821.245384693146,humanoid-walk,818,ALM
168,2100000,4200000,4200,773.3031420627286,2100000,40057.68843746185,humanoid-walk,818,ALM
169,2112500,4225000,4225,815.3764551756781,2112500,40295.83585071564,humanoid-walk,818,ALM
170,2125000,4250000,4250,871.4975335655238,2125000,40532.21247005463,humanoid-walk,818,ALM
171,2137500,4275000,4275,853.1750617892309,2137500,40768.51727461815,humanoid-walk,818,ALM
172,2150000,4300000,4300,779.2231715159269,2150000,41003.80804371834,humanoid-walk,818,ALM
173,2162500,4325000,4325,799.537976723505,2162500,41242.40520429611,humanoid-walk,818,ALM
174,2175000,4350000,4350,843.8994314668255,2175000,41479.85981178284,humanoid-walk,818,ALM
175,2187500,4375000,4375,871.7671477221726,2187500,41719.883929252625,humanoid-walk,818,ALM
176,2200000,4400000,4400,791.9114515902273,2200000,41959.531039476395,humanoid-walk,818,ALM
177,2212500,4425000,4425,896.859613748099,2212500,42197.20814013481,humanoid-walk,818,ALM
178,2225000,4450000,4450,895.8544626243335,2225000,42435.63462305069,humanoid-walk,818,ALM
179,2237500,4475000,4475,884.5090198653854,2237500,42674.15256404877,humanoid-walk,818,ALM
180,2250000,4500000,4500,834.5479854998182,2250000,42910.77444577217,humanoid-walk,818,ALM
181,2262500,4525000,4525,863.5299942186872,2262500,43146.444491147995,humanoid-walk,818,ALM
182,2275000,4550000,4550,757.1462994423935,2275000,43384.99309539795,humanoid-walk,818,ALM
183,2287500,4575000,4575,890.3125633767793,2287500,43623.20203757286,humanoid-walk,818,ALM
184,2300000,4600000,4600,884.7505764897478,2300000,43859.79801440239,humanoid-walk,818,ALM
185,2312500,4625000,4625,876.0478174482208,2312500,44094.09922838211,humanoid-walk,818,ALM
186,2325000,4650000,4650,779.4075749910884,2325000,44330.718228816986,humanoid-walk,818,ALM
187,2337500,4675000,4675,712.0162414858087,2337500,44566.21391391754,humanoid-walk,818,ALM
188,2350000,4700000,4700,912.0973209115282,2350000,44800.692449092865,humanoid-walk,818,ALM
189,2362500,4725000,4725,900.5904267567387,2362500,45037.809468746185,humanoid-walk,818,ALM
190,2375000,4750000,4750,916.0535887078662,2375000,45274.14975976944,humanoid-walk,818,ALM
191,2387500,4775000,4775,891.3795577977138,2387500,45510.63210606575,humanoid-walk,818,ALM
192,2400000,4800000,4800,906.3497659835919,2400000,45747.3644554615,humanoid-walk,818,ALM
193,2412500,4825000,4825,922.245064667674,2412500,45982.994170188904,humanoid-walk,818,ALM
194,2425000,4850000,4850,911.5553867003691,2425000,46216.73256802559,humanoid-walk,818,ALM
195,2437500,4875000,4875,907.5732154142795,2437500,46450.75233244896,humanoid-walk,818,ALM
196,2450000,4900000,4900,887.6310730513657,2450000,46686.32793736458,humanoid-walk,818,ALM
197,2462500,4925000,4925,918.6774013163315,2462500,46922.08855366707,humanoid-walk,818,ALM
198,2475000,4950000,4950,891.1031099066397,2475000,47158.09024953842,humanoid-walk,818,ALM
199,2487500,4975000,4975,901.9230074642594,2487500,47396.82286787033,humanoid-walk,818,ALM
0,0,0,0,6.606873648613143,0,36.22712850570679,dog-walk,267,ALM
1,12500,25000,25,10.422426559757106,12500,316.0535526275635,dog-walk,267,ALM
2,25000,50000,50,10.887143931433474,25000,646.4758877754211,dog-walk,267,ALM
3,37500,75000,75,10.585836962934668,37500,970.4935626983643,dog-walk,267,ALM
4,50000,100000,100,15.390555036041382,50000,1292.9742348194122,dog-walk,267,ALM
5,62500,125000,125,7.648297176424317,62500,1597.4495522975922,dog-walk,267,ALM
6,75000,150000,150,21.56693753040203,75000,1884.6207115650177,dog-walk,267,ALM
7,87500,175000,175,11.293758026215922,87500,2177.050804376602,dog-walk,267,ALM
8,100000,200000,200,20.231630055438934,100000,2473.0275642871857,dog-walk,267,ALM
9,112500,225000,225,16.44596387268937,112500,2800.6475937366486,dog-walk,267,ALM
10,125000,250000,250,8.233795403554655,125000,3121.130202293396,dog-walk,267,ALM
11,137500,275000,275,4.950772623515108,137500,3454.318469285965,dog-walk,267,ALM
12,150000,300000,300,10.818342623291736,150000,3788.4237701892853,dog-walk,267,ALM
13,162500,325000,325,13.101997609625855,162500,4094.8709206581116,dog-walk,267,ALM
14,175000,350000,350,12.237213163721869,175000,4413.957302331924,dog-walk,267,ALM
15,187500,375000,375,19.195593283974652,187500,4734.764413356781,dog-walk,267,ALM
16,200000,400000,400,10.060030009050934,200000,5056.723558664322,dog-walk,267,ALM
17,212500,425000,425,29.62738600808307,212500,5361.276678562164,dog-walk,267,ALM
18,225000,450000,450,14.918791037730287,225000,5664.285773515701,dog-walk,267,ALM
19,237500,475000,475,7.011629925926059,237500,5969.40026807785,dog-walk,267,ALM
20,250000,500000,500,10.444042785626511,250000,6283.919529914856,dog-walk,267,ALM
21,262500,525000,525,28.778689594886533,262500,6584.621621131897,dog-walk,267,ALM
22,275000,550000,550,10.9284652245324,275000,6895.296236991882,dog-walk,267,ALM
23,287500,575000,575,36.264470137103565,287500,7213.04651260376,dog-walk,267,ALM
24,300000,600000,600,16.690542913197117,300000,7528.719984531403,dog-walk,267,ALM
25,312500,625000,625,20.342309104831468,312500,7844.887681484222,dog-walk,267,ALM
26,325000,650000,650,12.359746193335425,325000,8144.7935791015625,dog-walk,267,ALM
27,337500,675000,675,35.808741901432455,337500,8451.208248138428,dog-walk,267,ALM
28,350000,700000,700,12.603097476237874,350000,8761.823816776276,dog-walk,267,ALM
29,362500,725000,725,20.612254501069163,362500,9059.200637102127,dog-walk,267,ALM
30,375000,750000,750,15.448331044607698,375000,9355.807026386261,dog-walk,267,ALM
31,387500,775000,775,11.110198369277043,387500,9673.388958454132,dog-walk,267,ALM
32,400000,800000,800,12.876333974692386,400000,9974.879248380661,dog-walk,267,ALM
33,412500,825000,825,69.63664881164587,412500,10246.531944513321,dog-walk,267,ALM
34,425000,850000,850,130.7613530377738,425000,10558.210504770279,dog-walk,267,ALM
35,437500,875000,875,105.16568386639054,437500,10854.29778432846,dog-walk,267,ALM
36,450000,900000,900,172.02931300160338,450000,11162.333839654922,dog-walk,267,ALM
37,462500,925000,925,139.69982248860157,462500,11461.879359483719,dog-walk,267,ALM
38,475000,950000,950,187.01235472732665,475000,11759.163074970245,dog-walk,267,ALM
39,487500,975000,975,208.1240306364044,487500,12056.561346769333,dog-walk,267,ALM
40,500000,1000000,1000,214.70344224407071,500000,12370.343499183655,dog-walk,267,ALM
41,512500,1025000,1025,255.4245624692663,512500,12669.425094366074,dog-walk,267,ALM
42,525000,1050000,1050,242.55449586192822,525000,12979.293228149414,dog-walk,267,ALM
43,537500,1075000,1075,262.3350190592736,537500,13292.739883422852,dog-walk,267,ALM
44,550000,1100000,1100,244.44909951916657,550000,13585.106903553009,dog-walk,267,ALM
45,562500,1125000,1125,257.4708009618071,562500,13899.406519412994,dog-walk,267,ALM
46,575000,1150000,1150,279.3783168429669,575000,14196.728870153427,dog-walk,267,ALM
47,587500,1175000,1175,317.3996326123336,587500,14485.376194953918,dog-walk,267,ALM
48,600000,1200000,1200,272.72254235775654,600000,14778.219674825668,dog-walk,267,ALM
49,612500,1225000,1225,290.91747302304583,612500,15090.45155119896,dog-walk,267,ALM
50,625000,1250000,1250,312.695743877316,625000,15368.678044557571,dog-walk,267,ALM
51,637500,1275000,1275,332.71571797323566,637500,15658.675079345703,dog-walk,267,ALM
52,650000,1300000,1300,345.2602625982974,650000,15948.712287902832,dog-walk,267,ALM
53,662500,1325000,1325,379.88406538661485,662500,16252.473962545395,dog-walk,267,ALM
54,675000,1350000,1350,347.45536701319975,675000,16561.306495666504,dog-walk,267,ALM
55,687500,1375000,1375,371.69598542723713,687500,16875.530826568604,dog-walk,267,ALM
56,700000,1400000,1400,457.52319207144075,700000,17182.249688386917,dog-walk,267,ALM
57,712500,1425000,1425,409.63249807894755,712500,17490.656838417053,dog-walk,267,ALM
58,725000,1450000,1450,450.812095684606,725000,17798.590554475784,dog-walk,267,ALM
59,737500,1475000,1475,500.0653771337032,737500,18110.80506324768,dog-walk,267,ALM
60,750000,1500000,1500,553.0598026579842,750000,18410.673283338547,dog-walk,267,ALM
61,762500,1525000,1525,502.3268206531966,762500,18681.510860919952,dog-walk,267,ALM
62,775000,1550000,1550,436.19825314166485,775000,18972.058710575104,dog-walk,267,ALM
63,787500,1575000,1575,552.320250290322,787500,19278.03764486313,dog-walk,267,ALM
64,800000,1600000,1600,432.2294583206405,800000,19601.75370168686,dog-walk,267,ALM
65,812500,1625000,1625,551.0988311978654,812500,19919.43678712845,dog-walk,267,ALM
66,825000,1650000,1650,578.0630445045451,825000,20210.466690063477,dog-walk,267,ALM
67,837500,1675000,1675,564.5032998433346,837500,20482.88009285927,dog-walk,267,ALM
68,850000,1700000,1700,631.6835046961268,850000,20794.295536756516,dog-walk,267,ALM
69,862500,1725000,1725,650.118729981564,862500,21102.389144420624,dog-walk,267,ALM
70,875000,1750000,1750,618.9603410306861,875000,21415.702250003815,dog-walk,267,ALM
71,887500,1775000,1775,550.2878542283297,887500,21728.730430603027,dog-walk,267,ALM
72,900000,1800000,1800,665.3419695637152,900000,22037.573385477066,dog-walk,267,ALM
73,912500,1825000,1825,646.6046313770128,912500,22338.721678495407,dog-walk,267,ALM
74,925000,1850000,1850,642.5665701979814,925000,22645.673810005188,dog-walk,267,ALM
75,937500,1875000,1875,658.2091539360114,937500,22953.306618213654,dog-walk,267,ALM
76,950000,1900000,1900,647.725892505231,950000,23253.397770166397,dog-walk,267,ALM
77,962500,1925000,1925,667.5024479247711,962500,23553.123771429062,dog-walk,267,ALM
78,975000,1950000,1950,639.9868384979736,975000,23843.65552020073,dog-walk,267,ALM
79,987500,1975000,1975,699.9475482134118,987500,24132.24539899826,dog-walk,267,ALM
80,1000000,2000000,2000,753.6934944239171,1000000,24433.34840941429,dog-walk,267,ALM
81,1012500,2025000,2025,780.5520565420321,1012500,24700.2566947937,dog-walk,267,ALM
82,1025000,2050000,2050,793.9943958490526,1025000,24980.503167390823,dog-walk,267,ALM
83,1037500,2075000,2075,808.5991077527685,1037500,25261.07189631462,dog-walk,267,ALM
84,1050000,2100000,2100,680.0492343803973,1050000,25546.854023218155,dog-walk,267,ALM
85,1062500,2125000,2125,766.889474057685,1062500,25853.05213713646,dog-walk,267,ALM
86,1075000,2150000,2150,813.8899633209476,1075000,26142.978033065796,dog-walk,267,ALM
87,1087500,2175000,2175,810.7717543925652,1087500,26425.83978319168,dog-walk,267,ALM
88,1100000,2200000,2200,794.7625456053653,1100000,26707.966951608658,dog-walk,267,ALM
89,1112500,2225000,2225,814.4876420781093,1112500,27008.686854839325,dog-walk,267,ALM
90,1125000,2250000,2250,805.5925091477629,1125000,27290.99952507019,dog-walk,267,ALM
91,1137500,2275000,2275,809.051627511224,1137500,27573.22744345665,dog-walk,267,ALM
92,1150000,2300000,2300,825.7188540163773,1150000,27881.782505512238,dog-walk,267,ALM
93,1162500,2325000,2325,791.011250661801,1162500,28183.248324871063,dog-walk,267,ALM
94,1175000,2350000,2350,770.1774787268595,1175000,28491.48550772667,dog-walk,267,ALM
95,1187500,2375000,2375,759.2937586561515,1187500,28776.626983642578,dog-walk,267,ALM
96,1200000,2400000,2400,831.2019190176018,1200000,29074.825330257416,dog-walk,267,ALM
97,1212500,2425000,2425,766.5950088697363,1212500,29342.613883972168,dog-walk,267,ALM
98,1225000,2450000,2450,795.0786450352882,1225000,29633.29381632805,dog-walk,267,ALM
99,1237500,2475000,2475,840.4069122872112,1237500,29932.342846870422,dog-walk,267,ALM
100,1250000,2500000,2500,734.8054919514881,1250000,30241.15243935585,dog-walk,267,ALM
101,1262500,2525000,2525,810.0827095803738,1262500,30540.75584769249,dog-walk,267,ALM
102,1275000,2550000,2550,754.8244867606467,1275000,30805.197682857513,dog-walk,267,ALM
103,1287500,2575000,2575,765.5341136417419,1287500,31078.554297447205,dog-walk,267,ALM
104,1300000,2600000,2600,837.4155820992344,1300000,31367.940579414368,dog-walk,267,ALM
105,1312500,2625000,2625,826.5129220170722,1312500,31660.53646850586,dog-walk,267,ALM
106,1325000,2650000,2650,873.1128945502398,1325000,31939.415637016296,dog-walk,267,ALM
107,1337500,2675000,2675,832.9524757050336,1337500,32200.495386362076,dog-walk,267,ALM
108,1350000,2700000,2700,832.7727953434218,1350000,32471.24780201912,dog-walk,267,ALM
109,1362500,2725000,2725,801.0952497696505,1362500,32764.190408229828,dog-walk,267,ALM
110,1375000,2750000,2750,874.7842562714368,1375000,33054.11767530441,dog-walk,267,ALM
111,1387500,2775000,2775,855.4731087216184,1387500,33359.32253861427,dog-walk,267,ALM
112,1400000,2800000,2800,887.2708124842997,1400000,33650.53722548485,dog-walk,267,ALM
113,1412500,2825000,2825,887.8753177985722,1412500,33925.860609292984,dog-walk,267,ALM
114,1425000,2850000,2850,864.0928538166476,1425000,34188.9044752121,dog-walk,267,ALM
115,1437500,2875000,2875,908.0981618569589,1437500,34451.10767841339,dog-walk,267,ALM
116,1450000,2900000,2900,877.0497731614893,1450000,34713.722213983536,dog-walk,267,ALM
117,1462500,2925000,2925,827.3837767733136,1462500,34978.15723824501,dog-walk,267,ALM
118,1475000,2950000,2950,867.7644967896583,1475000,35249.86919116974,dog-walk,267,ALM
119,1487500,2975000,2975,901.5717295213917,1487500,35510.96749830246,dog-walk,267,ALM
120,1500000,3000000,3000,897.3959994944801,1500000,35771.55623841286,dog-walk,267,ALM
121,1512500,3025000,3025,875.9399728248045,1512500,36035.82524180412,dog-walk,267,ALM
122,1525000,3050000,3050,897.7198889504677,1525000,36298.21446275711,dog-walk,267,ALM
123,1537500,3075000,3075,877.6327157606642,1537500,36559.126271247864,dog-walk,267,ALM
124,1550000,3100000,3100,853.1071706709057,1550000,36820.78131341934,dog-walk,267,ALM
125,1562500,3125000,3125,855.915989028754,1562500,37081.58418440819,dog-walk,267,ALM
126,1575000,3150000,3150,920.9383039929547,1575000,37342.37012767792,dog-walk,267,ALM
127,1587500,3175000,3175,886.093362685098,1587500,37603.440034627914,dog-walk,267,ALM
128,1600000,3200000,3200,892.7611669990104,1600000,37865.95789718628,dog-walk,267,ALM
129,1612500,3225000,3225,870.6919361457228,1612500,38126.76921224594,dog-walk,267,ALM
130,1625000,3250000,3250,902.2313838889097,1625000,38387.09968185425,dog-walk,267,ALM
131,1637500,3275000,3275,909.1735405681086,1637500,38647.7564997673,dog-walk,267,ALM
132,1650000,3300000,3300,889.2739615109033,1650000,38907.17644762993,dog-walk,267,ALM
133,1662500,3325000,3325,868.2155760938716,1662500,39169.082035541534,dog-walk,267,ALM
134,1675000,3350000,3350,877.8512691685273,1675000,39434.14564061165,dog-walk,267,ALM
135,1687500,3375000,3375,875.1322679044754,1687500,39698.033202409744,dog-walk,267,ALM
136,1700000,3400000,3400,890.8129027340032,1700000,39967.17097902298,dog-walk,267,ALM
137,1712500,3425000,3425,914.5119963646375,1712500,40231.483409404755,dog-walk,267,ALM
138,1725000,3450000,3450,869.0447008911087,1725000,40494.629274606705,dog-walk,267,ALM
139,1737500,3475000,3475,868.4985496761608,1737500,40754.926674604416,dog-walk,267,ALM
140,1750000,3500000,3500,862.2458082659989,1750000,41015.65792655945,dog-walk,267,ALM
141,1762500,3525000,3525,832.1311428543935,1762500,41295.50584554672,dog-walk,267,ALM
142,1775000,3550000,3550,833.1797802565646,1775000,41604.822706222534,dog-walk,267,ALM
143,1787500,3575000,3575,778.9250061031714,1787500,41895.95924592018,dog-walk,267,ALM
144,1800000,3600000,3600,796.584007920703,1800000,42161.454647779465,dog-walk,267,ALM
145,1812500,3625000,3625,782.9926067546205,1812500,42425.979774951935,dog-walk,267,ALM
146,1825000,3650000,3650,894.8701331382169,1825000,42688.7276494503,dog-walk,267,ALM
147,1837500,3675000,3675,917.3241680355829,1837500,42951.01955676079,dog-walk,267,ALM
148,1850000,3700000,3700,898.0999629712948,1850000,43213.844415187836,dog-walk,267,ALM
149,1862500,3725000,3725,904.4881850771881,1862500,43489.65349364281,dog-walk,267,ALM
150,1875000,3750000,3750,809.0540607504481,1875000,43758.323772192,dog-walk,267,ALM
151,1887500,3775000,3775,741.806627949343,1887500,44034.46614766121,dog-walk,267,ALM
152,1900000,3800000,3800,881.1213687820458,1900000,44304.90142965317,dog-walk,267,ALM
153,1912500,3825000,3825,921.5608072178566,1912500,44566.8442234993,dog-walk,267,ALM
154,1925000,3850000,3850,914.642389576202,1925000,44828.01021242142,dog-walk,267,ALM
155,1937500,3875000,3875,909.88027675383,1937500,45090.13479304314,dog-walk,267,ALM
156,1950000,3900000,3900,917.0946633909391,1950000,45363.0016374588,dog-walk,267,ALM
157,1962500,3925000,3925,880.0818658930939,1962500,45637.61688232422,dog-walk,267,ALM
158,1975000,3950000,3950,922.0927198394104,1975000,45911.46928501129,dog-walk,267,ALM
159,1987500,3975000,3975,889.654204121189,1987500,46179.43634915352,dog-walk,267,ALM
160,2000000,4000000,4000,905.1123098122287,2000000,46446.402326107025,dog-walk,267,ALM
161,2012500,4025000,4025,839.6327999749403,2012500,46724.46136069298,dog-walk,267,ALM
162,2025000,4050000,4050,729.0344442807674,2025000,46999.69891858101,dog-walk,267,ALM
163,2037500,4075000,4075,876.429856346485,2037500,47268.51392245293,dog-walk,267,ALM
164,2050000,4100000,4100,895.0980089766961,2050000,47533.30319046974,dog-walk,267,ALM
165,2062500,4125000,4125,895.9704617886373,2062500,47801.62424373627,dog-walk,267,ALM
166,2075000,4150000,4150,857.277674554588,2075000,48075.494674921036,dog-walk,267,ALM
167,2087500,4175000,4175,798.3540296247727,2087500,48351.490069150925,dog-walk,267,ALM
168,2100000,4200000,4200,143.03155460707904,2100000,48627.53963923454,dog-walk,267,ALM
169,2112500,4225000,4225,840.2665289236613,2112500,48895.58430457115,dog-walk,267,ALM
170,2125000,4250000,4250,927.3071779763277,2125000,49164.994121313095,dog-walk,267,ALM
171,2137500,4275000,4275,893.8313507696836,2137500,49426.08597588539,dog-walk,267,ALM
172,2150000,4300000,4300,804.1252781758878,2150000,49693.67178249359,dog-walk,267,ALM
173,2162500,4325000,4325,833.142943010617,2162500,49959.24613904953,dog-walk,267,ALM
174,2175000,4350000,4350,840.9587020444336,2175000,50223.82470536232,dog-walk,267,ALM
175,2187500,4375000,4375,742.3401060093897,2187500,50487.298882484436,dog-walk,267,ALM
176,2200000,4400000,4400,770.8208257168784,2200000,50750.21643567085,dog-walk,267,ALM
177,2212500,4425000,4425,882.8627211532461,2212500,51011.07604932785,dog-walk,267,ALM
178,2225000,4450000,4450,851.2484318819619,2225000,51272.058864831924,dog-walk,267,ALM
179,2237500,4475000,4475,770.3329725888187,2237500,51530.83883309364,dog-walk,267,ALM
180,2250000,4500000,4500,837.8022517827378,2250000,51791.79531931877,dog-walk,267,ALM
181,2262500,4525000,4525,914.23364296696,2262500,52054.20985221863,dog-walk,267,ALM
182,2275000,4550000,4550,760.3314820574662,2275000,52316.948479652405,dog-walk,267,ALM
183,2287500,4575000,4575,875.9887784486712,2287500,52578.96649360657,dog-walk,267,ALM
184,2300000,4600000,4600,925.7555903643748,2300000,52844.823281764984,dog-walk,267,ALM
185,2312500,4625000,4625,855.4736933693972,2312500,53107.007462739944,dog-walk,267,ALM
186,2325000,4650000,4650,844.2041894431517,2325000,53367.97054076195,dog-walk,267,ALM
187,2337500,4675000,4675,896.379598396469,2337500,53633.95966362953,dog-walk,267,ALM
188,2350000,4700000,4700,887.2644864833859,2350000,53896.464057445526,dog-walk,267,ALM
189,2362500,4725000,4725,905.187161035501,2362500,54183.3188252449,dog-walk,267,ALM
190,2375000,4750000,4750,894.843091809647,2375000,54459.09956049919,dog-walk,267,ALM
191,2387500,4775000,4775,918.6809940841601,2387500,54720.458315849304,dog-walk,267,ALM
192,2400000,4800000,4800,949.185193685779,2400000,54982.69791722298,dog-walk,267,ALM
193,2412500,4825000,4825,907.212398243905,2412500,55242.4946975708,dog-walk,267,ALM
194,2425000,4850000,4850,928.1884345229694,2425000,55503.60345029831,dog-walk,267,ALM
195,2437500,4875000,4875,890.9754493521319,2437500,55767.294077157974,dog-walk,267,ALM
196,2450000,4900000,4900,933.0629712477778,2450000,56030.03029417992,dog-walk,267,ALM
197,2462500,4925000,4925,932.0903102607688,2462500,56291.78243017197,dog-walk,267,ALM
198,2475000,4950000,4950,900.4877061813249,2475000,56556.01635670662,dog-walk,267,ALM
199,2487500,4975000,4975,910.2523393460672,2487500,56818.44072294235,dog-walk,267,ALM
0,0,0,0,8.149706769342504,0,35.763065814971924,dog-walk,639,ALM
1,12500,25000,25,8.361880268343338,12500,289.88662123680115,dog-walk,639,ALM
2,25000,50000,50,17.670358420543124,25000,567.6066462993622,dog-walk,639,ALM
3,37500,75000,75,12.484289088775565,37500,853.5669043064117,dog-walk,639,ALM
4,50000,100000,100,10.882086657641997,50000,1149.30424618721,dog-walk,639,ALM
5,62500,125000,125,11.212738129083752,62500,1474.7942063808441,dog-walk,639,ALM
6,75000,150000,150,22.04882857918769,75000,1782.9864506721497,dog-walk,639,ALM
7,87500,175000,175,19.30864034914235,87500,2058.96733379364,dog-walk,639,ALM
8,100000,200000,200,9.744096323864278,100000,2368.7531526088715,dog-walk,639,ALM
9,112500,225000,225,11.138453202614638,112500,2692.024558544159,dog-walk,639,ALM
10,125000,250000,250,12.866124118266033,125000,3000.8142240047455,dog-walk,639,ALM
11,137500,275000,275,23.437006954010506,137500,3274.743013858795,dog-walk,639,ALM
12,150000,300000,300,19.66111747352489,150000,3560.6091117858887,dog-walk,639,ALM
13,162500,325000,325,18.656492580631287,162500,3881.5276334285736,dog-walk,639,ALM
14,175000,350000,350,14.185602975163103,175000,4202.981669187546,dog-walk,639,ALM
15,187500,375000,375,18.144399381963936,187500,4521.279018878937,dog-walk,639,ALM
16,200000,400000,400,29.224664542639125,200000,4838.300678730011,dog-walk,639,ALM
17,212500,425000,425,35.53765753598544,212500,5149.717249631882,dog-walk,639,ALM
18,225000,450000,450,18.868722964218964,225000,5461.534718990326,dog-walk,639,ALM
19,237500,475000,475,45.85523265450276,237500,5730.151947259903,dog-walk,639,ALM
20,250000,500000,500,37.84191525134276,250000,6031.135079622269,dog-walk,639,ALM
21,262500,525000,525,39.02952577982001,262500,6341.75537443161,dog-walk,639,ALM
22,275000,550000,550,21.819572838940807,275000,6639.5087258815765,dog-walk,639,ALM
23,287500,575000,575,65.49957473249978,287500,6912.116728544235,dog-walk,639,ALM
24,300000,600000,600,70.47277665650005,300000,7188.357807159424,dog-walk,639,ALM
25,312500,625000,625,92.24934840193846,312500,7462.191416978836,dog-walk,639,ALM
26,325000,650000,650,89.27382360749536,325000,7752.399243593216,dog-walk,639,ALM
27,337500,675000,675,91.57866307643059,337500,8051.622620820999,dog-walk,639,ALM
28,350000,700000,700,105.32435202869367,350000,8315.48153758049,dog-walk,639,ALM
29,362500,725000,725,82.90285854880089,362500,8580.020759105682,dog-walk,639,ALM
30,375000,750000,750,110.05324423370541,375000,8844.112313508987,dog-walk,639,ALM
31,387500,775000,775,78.84956064109595,387500,9108.730405330658,dog-walk,639,ALM
32,400000,800000,800,131.95736468054776,400000,9370.613723039627,dog-walk,639,ALM
33,412500,825000,825,100.39901541125855,412500,9631.714203596115,dog-walk,639,ALM
34,425000,850000,850,134.15134736936685,425000,9893.438728809357,dog-walk,639,ALM
35,437500,875000,875,86.61143283037175,437500,10154.419339895248,dog-walk,639,ALM
36,450000,900000,900,115.0716582738678,450000,10412.708837032318,dog-walk,639,ALM
37,462500,925000,925,123.63287510984996,462500,10672.575037240982,dog-walk,639,ALM
38,475000,950000,950,147.07984872272888,475000,10932.423273801804,dog-walk,639,ALM
39,487500,975000,975,130.6546617098495,487500,11191.28447175026,dog-walk,639,ALM
40,500000,1000000,1000,144.7610786109925,500000,11451.321328878403,dog-walk,639,ALM
41,512500,1025000,1025,169.47375616195586,512500,11714.369686841965,dog-walk,639,ALM
42,525000,1050000,1050,211.46105290281866,525000,11972.775694608688,dog-walk,639,ALM
43,537500,1075000,1075,221.33200565805836,537500,12234.098532676697,dog-walk,639,ALM
44,550000,1100000,1100,293.05773365171615,550000,12494.014686584473,dog-walk,639,ALM
45,562500,1125000,1125,321.8099076492241,562500,12752.081664800644,dog-walk,639,ALM
46,575000,1150000,1150,265.11730927820435,575000,13009.808088302612,dog-walk,639,ALM
47,587500,1175000,1175,263.46529334821673,587500,13269.844690799713,dog-walk,639,ALM
48,600000,1200000,1200,319.09281853072855,600000,13530.866920471191,dog-walk,639,ALM
49,612500,1225000,1225,394.69705048484013,612500,13790.322033643723,dog-walk,639,ALM
50,625000,1250000,1250,348.44278481650707,625000,14049.958683252335,dog-walk,639,ALM
51,637500,1275000,1275,435.9715691204784,637500,14309.783494234085,dog-walk,639,ALM
52,650000,1300000,1300,339.5172008630444,650000,14568.070758104324,dog-walk,639,ALM
53,662500,1325000,1325,348.97619851784094,662500,14826.890686511993,dog-walk,639,ALM
54,675000,1350000,1350,389.51014108205084,675000,15100.184184074402,dog-walk,639,ALM
55,687500,1375000,1375,366.5046221635579,687500,15387.925057888031,dog-walk,639,ALM
56,700000,1400000,1400,352.5747863158452,700000,15671.048813581467,dog-walk,639,ALM
57,712500,1425000,1425,443.0794802769422,712500,15986.280066251755,dog-walk,639,ALM
58,725000,1450000,1450,450.8892964332338,725000,16275.90548157692,dog-walk,639,ALM
59,737500,1475000,1475,495.98310365899385,737500,16582.339451551437,dog-walk,639,ALM
60,750000,1500000,1500,442.3104207036972,750000,16893.39502930641,dog-walk,639,ALM
61,762500,1525000,1525,432.23311264835195,762500,17218.016987800598,dog-walk,639,ALM
62,775000,1550000,1550,553.2506392755564,775000,17540.49032354355,dog-walk,639,ALM
63,787500,1575000,1575,599.0534262356421,787500,17858.56236743927,dog-walk,639,ALM
64,800000,1600000,1600,498.93985286797067,800000,18155.348885536194,dog-walk,639,ALM
65,812500,1625000,1625,478.4659777511191,812500,18427.04625105858,dog-walk,639,ALM
66,825000,1650000,1650,521.1009869383898,825000,18698.660207748413,dog-walk,639,ALM
67,837500,1675000,1675,590.4829576795312,837500,18979.520958662033,dog-walk,639,ALM
68,850000,1700000,1700,607.3712566075332,850000,19247.03155899048,dog-walk,639,ALM
69,862500,1725000,1725,629.4857335779428,862500,19513.150568962097,dog-walk,639,ALM
70,875000,1750000,1750,616.3393473089541,875000,19781.010999917984,dog-walk,639,ALM
71,887500,1775000,1775,605.279300012174,887500,20049.211295366287,dog-walk,639,ALM
72,900000,1800000,1800,584.8184663644936,900000,20317.506023168564,dog-walk,639,ALM
73,912500,1825000,1825,591.4535034957596,912500,20586.39429473877,dog-walk,639,ALM
74,925000,1850000,1850,642.2463708463,925000,20853.442060232162,dog-walk,639,ALM
75,937500,1875000,1875,645.2053474758217,937500,21119.43252182007,dog-walk,639,ALM
76,950000,1900000,1900,599.530335781841,950000,21389.78965473175,dog-walk,639,ALM
77,962500,1925000,1925,551.2533354675709,962500,21662.977831840515,dog-walk,639,ALM
78,975000,1950000,1950,530.0772293587488,975000,21931.93020749092,dog-walk,639,ALM
79,987500,1975000,1975,554.1923300341166,987500,22202.249146938324,dog-walk,639,ALM
80,1000000,2000000,2000,556.4821598846321,1000000,22469.371668577194,dog-walk,639,ALM
81,1012500,2025000,2025,575.2399229812306,1012500,22737.17895936966,dog-walk,639,ALM
82,1025000,2050000,2050,594.5931062340213,1025000,23010.090348482132,dog-walk,639,ALM
83,1037500,2075000,2075,606.9753175230716,1037500,23276.650948524475,dog-walk,639,ALM
84,1050000,2100000,2100,540.865733349786,1050000,23545.09829711914,dog-walk,639,ALM
85,1062500,2125000,2125,615.3169872151016,1062500,23813.830415010452,dog-walk,639,ALM
86,1075000,2150000,2150,617.2125949528008,1075000,24083.510399580002,dog-walk,639,ALM
87,1087500,2175000,2175,635.1678342642548,1087500,24353.774646520615,dog-walk,639,ALM
88,1100000,2200000,2200,686.3075124574682,1100000,24620.430047512054,dog-walk,639,ALM
89,1112500,2225000,2225,695.5489251810311,1112500,24890.420063734055,dog-walk,639,ALM
90,1125000,2250000,2250,727.8200743405947,1125000,25158.613063573837,dog-walk,639,ALM
91,1137500,2275000,2275,592.0322325169067,1137500,25425.763498067856,dog-walk,639,ALM
92,1150000,2300000,2300,679.2174010638428,1150000,25692.148539304733,dog-walk,639,ALM
93,1162500,2325000,2325,569.4693313715076,1162500,25960.34507369995,dog-walk,639,ALM
94,1175000,2350000,2350,637.6644681345871,1175000,26226.377634763718,dog-walk,639,ALM
95,1187500,2375000,2375,752.549352008938,1187500,26491.27438569069,dog-walk,639,ALM
96,1200000,2400000,2400,657.6028483605011,1200000,26758.269815683365,dog-walk,639,ALM
97,1212500,2425000,2425,768.9454806661117,1212500,27022.086401939392,dog-walk,639,ALM
98,1225000,2450000,2450,730.4195107690082,1225000,27286.57280898094,dog-walk,639,ALM
99,1237500,2475000,2475,790.519606953085,1237500,27553.340848207474,dog-walk,639,ALM
100,1250000,2500000,2500,778.2572244069531,1250000,27820.589005708694,dog-walk,639,ALM
101,1262500,2525000,2525,796.0963229953409,1262500,28077.513340234756,dog-walk,639,ALM
102,1275000,2550000,2550,781.0635138278049,1275000,28333.375371217728,dog-walk,639,ALM
103,1287500,2575000,2575,801.6530511891543,1287500,28587.481166362762,dog-walk,639,ALM
104,1300000,2600000,2600,817.7068465447248,1300000,28841.692983150482,dog-walk,639,ALM
105,1312500,2625000,2625,778.1488830176443,1312500,29096.611284971237,dog-walk,639,ALM
106,1325000,2650000,2650,742.9195528146822,1325000,29354.922129154205,dog-walk,639,ALM
107,1337500,2675000,2675,836.1454576124391,1337500,29610.41152715683,dog-walk,639,ALM
108,1350000,2700000,2700,744.266425034389,1350000,29865.77887248993,dog-walk,639,ALM
109,1362500,2725000,2725,803.5767469318326,1362500,30121.80743098259,dog-walk,639,ALM
110,1375000,2750000,2750,781.0232566179968,1375000,30378.352804660797,dog-walk,639,ALM
111,1387500,2775000,2775,773.0565001732305,1387500,30641.473340034485,dog-walk,639,ALM
112,1400000,2800000,2800,812.8497943206922,1400000,30900.354293584824,dog-walk,639,ALM
113,1412500,2825000,2825,844.644289724065,1412500,31156.34885120392,dog-walk,639,ALM
114,1425000,2850000,2850,819.1308999017632,1425000,31412.98388504982,dog-walk,639,ALM
115,1437500,2875000,2875,802.5729653043082,1437500,31669.087997198105,dog-walk,639,ALM
116,1450000,2900000,2900,802.6236184538701,1450000,31930.835293293,dog-walk,639,ALM
117,1462500,2925000,2925,780.3694453881704,1462500,32187.04258966446,dog-walk,639,ALM
118,1475000,2950000,2950,853.526104714632,1475000,32445.180780410767,dog-walk,639,ALM
119,1487500,2975000,2975,843.4821486170888,1487500,32703.169686317444,dog-walk,639,ALM
120,1500000,3000000,3000,894.3381692241353,1500000,32958.36352133751,dog-walk,639,ALM
121,1512500,3025000,3025,882.7430374899038,1512500,33212.50231671333,dog-walk,639,ALM
122,1525000,3050000,3050,889.9877364150483,1525000,33467.41163277626,dog-walk,639,ALM
123,1537500,3075000,3075,830.7516889252256,1537500,33722.69991564751,dog-walk,639,ALM
124,1550000,3100000,3100,671.471827467764,1550000,33979.961903333664,dog-walk,639,ALM
125,1562500,3125000,3125,841.9894460891785,1562500,34236.38953614235,dog-walk,639,ALM
126,1575000,3150000,3150,891.0307245909892,1575000,34491.56962251663,dog-walk,639,ALM
127,1587500,3175000,3175,868.8774780542017,1587500,34746.00582551956,dog-walk,639,ALM
128,1600000,3200000,3200,905.0624068616571,1600000,35002.41371297836,dog-walk,639,ALM
129,1612500,3225000,3225,855.4407639676826,1612500,35259.54928398132,dog-walk,639,ALM
130,1625000,3250000,3250,883.437874953944,1625000,35519.40924978256,dog-walk,639,ALM
131,1637500,3275000,3275,762.7220186820555,1637500,35783.21527194977,dog-walk,639,ALM
132,1650000,3300000,3300,711.4845664192605,1650000,36038.95026612282,dog-walk,639,ALM
133,1662500,3325000,3325,874.5507402754076,1662500,36292.96265363693,dog-walk,639,ALM
134,1675000,3350000,3350,764.1291657819954,1675000,36546.65491962433,dog-walk,639,ALM
135,1687500,3375000,3375,871.5262802953409,1687500,36802.10305762291,dog-walk,639,ALM
136,1700000,3400000,3400,752.6487765476426,1700000,37059.257212638855,dog-walk,639,ALM
137,1712500,3425000,3425,599.7245024203311,1712500,37318.42338824272,dog-walk,639,ALM
138,1725000,3450000,3450,843.5671279510163,1725000,37578.489919662476,dog-walk,639,ALM
139,1737500,3475000,3475,843.7013445980898,1737500,37835.82115030289,dog-walk,639,ALM
140,1750000,3500000,3500,898.2002489238627,1750000,38093.65282416344,dog-walk,639,ALM
141,1762500,3525000,3525,888.6768106238317,1762500,38351.92857789993,dog-walk,639,ALM
142,1775000,3550000,3550,595.9760447773481,1775000,38609.65029358864,dog-walk,639,ALM
143,1787500,3575000,3575,725.0977892716595,1787500,38866.54075503349,dog-walk,639,ALM
144,1800000,3600000,3600,865.3440669745639,1800000,39121.88199257851,dog-walk,639,ALM
145,1812500,3625000,3625,893.2168081959368,1812500,39376.023940086365,dog-walk,639,ALM
146,1825000,3650000,3650,834.8672081746975,1825000,39635.81925225258,dog-walk,639,ALM
147,1837500,3675000,3675,869.5436550341789,1837500,39890.150420188904,dog-walk,639,ALM
148,1850000,3700000,3700,890.1209415770624,1850000,40146.37330722809,dog-walk,639,ALM
149,1862500,3725000,3725,893.7657228977299,1862500,40402.426171541214,dog-walk,639,ALM
150,1875000,3750000,3750,857.7178237423188,1875000,40659.66501355171,dog-walk,639,ALM
151,1887500,3775000,3775,875.6836189183896,1887500,40914.91916179657,dog-walk,639,ALM
152,1900000,3800000,3800,841.2687704185157,1900000,41170.85250687599,dog-walk,639,ALM
153,1912500,3825000,3825,902.3821217738196,1912500,41428.29418206215,dog-walk,639,ALM
154,1925000,3850000,3850,909.1110987984381,1925000,41683.92641496658,dog-walk,639,ALM
155,1937500,3875000,3875,896.2134585922713,1937500,41939.82400226593,dog-walk,639,ALM
156,1950000,3900000,3900,886.4268737367751,1950000,42197.79612779617,dog-walk,639,ALM
157,1962500,3925000,3925,905.3525834036275,1962500,42453.55980348587,dog-walk,639,ALM
158,1975000,3950000,3950,882.667380526851,1975000,42710.992377758026,dog-walk,639,ALM
159,1987500,3975000,3975,860.5440622913957,1987500,42969.30472278595,dog-walk,639,ALM
160,2000000,4000000,4000,887.4751833401745,2000000,43227.4636592865,dog-walk,639,ALM
161,2012500,4025000,4025,811.5638764040752,2012500,43487.02733850479,dog-walk,639,ALM
162,2025000,4050000,4050,822.3502976967266,2025000,43747.83219861984,dog-walk,639,ALM
163,2037500,4075000,4075,930.6939340825353,2037500,44007.72421169281,dog-walk,639,ALM
164,2050000,4100000,4100,872.0544968199735,2050000,44263.54050517082,dog-walk,639,ALM
165,2062500,4125000,4125,886.8920767152597,2062500,44679.573001623154,dog-walk,639,ALM
166,2075000,4150000,4150,877.2795369589261,2075000,44936.134319067,dog-walk,639,ALM
167,2087500,4175000,4175,902.0659143423964,2087500,45194.66677904129,dog-walk,639,ALM
168,2100000,4200000,4200,913.0526657758097,2100000,45451.0084092617,dog-walk,639,ALM
169,2112500,4225000,4225,811.3606289841271,2112500,45706.99374079704,dog-walk,639,ALM
170,2125000,4250000,4250,910.2334720912093,2125000,45961.96931672096,dog-walk,639,ALM
171,2137500,4275000,4275,842.4558302781559,2137500,46217.932752132416,dog-walk,639,ALM
172,2150000,4300000,4300,849.2287821927623,2150000,46474.669189453125,dog-walk,639,ALM
173,2162500,4325000,4325,915.0221693792233,2162500,46732.02940773964,dog-walk,639,ALM
174,2175000,4350000,4350,601.4540238738417,2175000,46993.315871715546,dog-walk,639,ALM
175,2187500,4375000,4375,580.2452633643022,2187500,47258.862107753754,dog-walk,639,ALM
176,2200000,4400000,4400,747.5677386980449,2200000,47531.911458969116,dog-walk,639,ALM
177,2212500,4425000,4425,878.9606024608523,2212500,47832.96023797989,dog-walk,639,ALM
178,2225000,4450000,4450,893.2931699140472,2225000,48115.008862257004,dog-walk,639,ALM
179,2237500,4475000,4475,884.962438994854,2237500,48371.58432483673,dog-walk,639,ALM
180,2250000,4500000,4500,907.1876533799784,2250000,48628.43488049507,dog-walk,639,ALM
181,2262500,4525000,4525,906.0649521328589,2262500,48889.857642412186,dog-walk,639,ALM
182,2275000,4550000,4550,882.3708248056276,2275000,49157.27303481102,dog-walk,639,ALM
183,2287500,4575000,4575,853.8021943497488,2287500,49431.90222454071,dog-walk,639,ALM
184,2300000,4600000,4600,901.709263196454,2300000,49688.96744441986,dog-walk,639,ALM
185,2312500,4625000,4625,837.976898247762,2312500,49946.8755671978,dog-walk,639,ALM
186,2325000,4650000,4650,921.9138331268987,2325000,50214.18328619003,dog-walk,639,ALM
187,2337500,4675000,4675,856.0848308487159,2337500,50473.56131696701,dog-walk,639,ALM
188,2350000,4700000,4700,867.5438639167571,2350000,50732.362577199936,dog-walk,639,ALM
189,2362500,4725000,4725,918.0925918894584,2362500,50989.40423679352,dog-walk,639,ALM
190,2375000,4750000,4750,930.8726063058418,2375000,51246.39812731743,dog-walk,639,ALM
191,2387500,4775000,4775,868.9777437795676,2387500,51513.463783979416,dog-walk,639,ALM
192,2400000,4800000,4800,701.635468572042,2400000,51788.59696865082,dog-walk,639,ALM
193,2412500,4825000,4825,924.6095729002475,2412500,52063.10791063309,dog-walk,639,ALM
194,2425000,4850000,4850,892.776716708061,2425000,52350.19462394714,dog-walk,639,ALM
195,2437500,4875000,4875,589.3009112330294,2437500,52608.392916202545,dog-walk,639,ALM
196,2450000,4900000,4900,913.173417773852,2450000,52875.608707904816,dog-walk,639,ALM
197,2462500,4925000,4925,777.7547230547483,2462500,53157.425974845886,dog-walk,639,ALM
198,2475000,4950000,4950,911.8579012122948,2475000,53448.99643135071,dog-walk,639,ALM
199,2487500,4975000,4975,903.455857966954,2487500,53719.650285959244,dog-walk,639,ALM
0,0,0,0,13.290327202905791,0,37.328943967819214,dog-walk,607,ALM
1,12500,25000,25,6.576373087065275,12500,282.0802710056305,dog-walk,607,ALM
2,25000,50000,50,14.168346748600953,25000,560.1399874687195,dog-walk,607,ALM
3,37500,75000,75,7.2804462737741975,37500,841.4932553768158,dog-walk,607,ALM
4,50000,100000,100,19.218317900513263,50000,1123.1532273292542,dog-walk,607,ALM
5,62500,125000,125,10.49993441442004,62500,1406.9940030574799,dog-walk,607,ALM
6,75000,150000,150,17.523172034556694,75000,1686.914855480194,dog-walk,607,ALM
7,87500,175000,175,10.673433599163818,87500,1966.9492633342743,dog-walk,607,ALM
8,100000,200000,200,11.278571053800455,100000,2242.0884811878204,dog-walk,607,ALM
9,112500,225000,225,23.40814429124668,112500,2515.8428103923798,dog-walk,607,ALM
10,125000,250000,250,11.130638236823854,125000,2787.4323151111603,dog-walk,607,ALM
11,137500,275000,275,12.50594685819301,137500,3057.5579977035522,dog-walk,607,ALM
12,150000,300000,300,11.243210285440735,150000,3329.62584066391,dog-walk,607,ALM
13,162500,325000,325,8.010367645281201,162500,3603.3482534885406,dog-walk,607,ALM
14,175000,350000,350,9.239313988098965,175000,3879.3023998737335,dog-walk,607,ALM
15,187500,375000,375,16.634280420461504,187500,4147.2602961063385,dog-walk,607,ALM
16,200000,400000,400,18.823172697073524,200000,4414.481213092804,dog-walk,607,ALM
17,212500,425000,425,19.115896123763974,212500,4680.70055937767,dog-walk,607,ALM
18,225000,450000,450,23.65510954784764,225000,4948.146103620529,dog-walk,607,ALM
19,237500,475000,475,10.77489361262679,237500,5215.5664498806,dog-walk,607,ALM
20,250000,500000,500,26.456454753500804,250000,5483.714683294296,dog-walk,607,ALM
21,262500,525000,525,54.93143922253449,262500,5749.211897850037,dog-walk,607,ALM
22,275000,550000,550,54.474884411002996,275000,6016.475459814072,dog-walk,607,ALM
23,287500,575000,575,125.5477801729811,287500,6281.94623541832,dog-walk,607,ALM
24,300000,600000,600,119.34531482765892,300000,6546.260474205017,dog-walk,607,ALM
25,312500,625000,625,76.11932377036837,312500,6810.000352859497,dog-walk,607,ALM
26,325000,650000,650,120.46786180744853,325000,7074.121569156647,dog-walk,607,ALM
27,337500,675000,675,161.7665036721659,337500,7335.997401475906,dog-walk,607,ALM
28,350000,700000,700,158.83080056483155,350000,7598.866475105286,dog-walk,607,ALM
29,362500,725000,725,177.6714434103615,362500,7867.513972759247,dog-walk,607,ALM
30,375000,750000,750,166.5943497388794,375000,8130.065973043442,dog-walk,607,ALM
31,387500,775000,775,176.14415705870852,387500,8393.386986970901,dog-walk,607,ALM
32,400000,800000,800,234.8098626170477,400000,8655.32100057602,dog-walk,607,ALM
33,412500,825000,825,232.81321602176814,412500,8917.821084737778,dog-walk,607,ALM
34,425000,850000,850,234.89413924877744,425000,9180.666041135788,dog-walk,607,ALM
35,437500,875000,875,245.35953436535686,437500,9442.422807693481,dog-walk,607,ALM
36,450000,900000,900,230.80953485853078,450000,9705.422882080078,dog-walk,607,ALM
37,462500,925000,925,273.60719421741305,462500,9969.222240686417,dog-walk,607,ALM
38,475000,950000,950,209.43670945875724,475000,10235.79064154625,dog-walk,607,ALM
39,487500,975000,975,369.4468595942943,487500,10500.600360631943,dog-walk,607,ALM
40,500000,1000000,1000,420.4242373425606,500000,10764.206052064896,dog-walk,607,ALM
41,512500,1025000,1025,363.9992498009088,512500,11029.861593484879,dog-walk,607,ALM
42,525000,1050000,1050,391.0632379034097,525000,11294.010008335114,dog-walk,607,ALM
43,537500,1075000,1075,453.80437615284154,537500,11556.022516727448,dog-walk,607,ALM
44,550000,1100000,1100,378.09184605440066,550000,11824.95949459076,dog-walk,607,ALM
45,562500,1125000,1125,400.3059464365027,562500,12085.713323354721,dog-walk,607,ALM
46,575000,1150000,1150,418.2580358840284,575000,12350.736945152283,dog-walk,607,ALM
47,587500,1175000,1175,460.41191732232164,587500,12614.725296020508,dog-walk,607,ALM
48,600000,1200000,1200,385.11155866063007,600000,12878.614742994308,dog-walk,607,ALM
49,612500,1225000,1225,485.1964510954966,612500,13141.816810131073,dog-walk,607,ALM
50,625000,1250000,1250,522.3635144912656,625000,13405.720940589905,dog-walk,607,ALM
51,637500,1275000,1275,488.51596587933955,637500,13667.857427835464,dog-walk,607,ALM
52,650000,1300000,1300,535.1484785882587,650000,13930.889778375626,dog-walk,607,ALM
53,662500,1325000,1325,619.6463059962458,662500,14195.600845098495,dog-walk,607,ALM
54,675000,1350000,1350,657.4170140364262,675000,14456.798632860184,dog-walk,607,ALM
55,687500,1375000,1375,667.8970311087999,687500,14717.863284111023,dog-walk,607,ALM
56,700000,1400000,1400,657.1648497349432,700000,14979.964268922806,dog-walk,607,ALM
57,712500,1425000,1425,678.2815259754109,712500,15240.690981149673,dog-walk,607,ALM
58,725000,1450000,1450,708.0806205990943,725000,15502.984662532806,dog-walk,607,ALM
59,737500,1475000,1475,714.7243514293972,737500,15766.221566677094,dog-walk,607,ALM
60,750000,1500000,1500,703.579922160539,750000,16026.427567243576,dog-walk,607,ALM
61,762500,1525000,1525,751.1631620122632,762500,16287.92473578453,dog-walk,607,ALM
62,775000,1550000,1550,686.4859189639759,775000,16546.948746919632,dog-walk,607,ALM
63,787500,1575000,1575,656.3079591795178,787500,16808.432064771652,dog-walk,607,ALM
64,800000,1600000,1600,695.2693357584458,800000,17069.269738435745,dog-walk,607,ALM
65,812500,1625000,1625,791.0185037139458,812500,17330.240572214127,dog-walk,607,ALM
66,825000,1650000,1650,768.4256936984101,825000,17592.209336280823,dog-walk,607,ALM
67,837500,1675000,1675,643.7395188493894,837500,17853.026091575623,dog-walk,607,ALM
68,850000,1700000,1700,806.2986360257671,850000,18113.69744324684,dog-walk,607,ALM
69,862500,1725000,1725,764.6048636798392,862500,18375.465901374817,dog-walk,607,ALM
70,875000,1750000,1750,731.7863418248805,875000,18638.2254884243,dog-walk,607,ALM
71,887500,1775000,1775,735.2046605924091,887500,18901.42967224121,dog-walk,607,ALM
72,900000,1800000,1800,771.9730011781247,900000,19162.479907751083,dog-walk,607,ALM
73,912500,1825000,1825,851.4207883069141,912500,19427.517020225525,dog-walk,607,ALM
74,925000,1850000,1850,807.3851347768659,925000,19693.225509166718,dog-walk,607,ALM
75,937500,1875000,1875,782.7562065665079,937500,19954.80653333664,dog-walk,607,ALM
76,950000,1900000,1900,789.3300814662375,950000,20218.123621225357,dog-walk,607,ALM
77,962500,1925000,1925,676.5950610397092,962500,20484.35224223137,dog-walk,607,ALM
78,975000,1950000,1950,691.0923292929635,975000,20748.384884357452,dog-walk,607,ALM
79,987500,1975000,1975,762.1368909464243,987500,21013.809788942337,dog-walk,607,ALM
80,1000000,2000000,2000,812.8348583474095,1000000,21273.321150779724,dog-walk,607,ALM
81,1012500,2025000,2025,848.3382785030024,1012500,21534.219223976135,dog-walk,607,ALM
82,1025000,2050000,2050,764.6201880144724,1025000,21797.145767211914,dog-walk,607,ALM
83,1037500,2075000,2075,863.3830625506359,1037500,22060.351437568665,dog-walk,607,ALM
84,1050000,2100000,2100,851.9421263340739,1050000,22323.89226603508,dog-walk,607,ALM
85,1062500,2125000,2125,859.6463958668597,1062500,22587.08545064926,dog-walk,607,ALM
86,1075000,2150000,2150,817.3784189784831,1075000,22847.47109103203,dog-walk,607,ALM
87,1087500,2175000,2175,836.0896315033427,1087500,23108.923229694366,dog-walk,607,ALM
88,1100000,2200000,2200,791.5934903805048,1100000,23370.58643913269,dog-walk,607,ALM
89,1112500,2225000,2225,783.7433623153885,1112500,23629.47128510475,dog-walk,607,ALM
90,1125000,2250000,2250,794.1661423344642,1125000,23886.773248672485,dog-walk,607,ALM
91,1137500,2275000,2275,833.8868239496342,1137500,24146.551394701004,dog-walk,607,ALM
92,1150000,2300000,2300,862.5747589313441,1150000,24402.566604852676,dog-walk,607,ALM
93,1162500,2325000,2325,830.0366283947585,1162500,24659.93452644348,dog-walk,607,ALM
94,1175000,2350000,2350,841.6649672341903,1175000,24920.418226718903,dog-walk,607,ALM
95,1187500,2375000,2375,881.5533298845514,1187500,25180.49355530739,dog-walk,607,ALM
96,1200000,2400000,2400,774.3381983831404,1200000,25438.060684919357,dog-walk,607,ALM
97,1212500,2425000,2425,835.718820414827,1212500,25694.230556964874,dog-walk,607,ALM
98,1225000,2450000,2450,783.3191495501702,1225000,25953.03543829918,dog-walk,607,ALM
99,1237500,2475000,2475,697.5943654263074,1237500,26212.95926785469,dog-walk,607,ALM
100,1250000,2500000,2500,689.1658919156637,1250000,26475.258972883224,dog-walk,607,ALM
101,1262500,2525000,2525,717.2468930901262,1262500,26738.364700078964,dog-walk,607,ALM
102,1275000,2550000,2550,873.2606387246858,1275000,26997.30900502205,dog-walk,607,ALM
103,1287500,2575000,2575,858.4995095359506,1287500,27259.399315834045,dog-walk,607,ALM
104,1300000,2600000,2600,844.0505699435018,1300000,27531.492048740387,dog-walk,607,ALM
105,1312500,2625000,2625,891.7955452035349,1312500,27791.280825138092,dog-walk,607,ALM
106,1325000,2650000,2650,895.0855287709071,1325000,28050.902793884277,dog-walk,607,ALM
107,1337500,2675000,2675,885.923153659832,1337500,28310.894040822983,dog-walk,607,ALM
108,1350000,2700000,2700,894.6258611810172,1350000,28570.807927131653,dog-walk,607,ALM
109,1362500,2725000,2725,855.7908423732133,1362500,28832.706573963165,dog-walk,607,ALM
110,1375000,2750000,2750,913.2793856118126,1375000,29091.598726034164,dog-walk,607,ALM
111,1387500,2775000,2775,766.450880823221,1387500,29351.465762615204,dog-walk,607,ALM
112,1400000,2800000,2800,710.7698113500898,1400000,29612.049836158752,dog-walk,607,ALM
113,1412500,2825000,2825,780.9948499303107,1412500,29874.188103199005,dog-walk,607,ALM
114,1425000,2850000,2850,744.592596269729,1425000,30135.021212100983,dog-walk,607,ALM
115,1437500,2875000,2875,870.9401424907024,1437500,30396.201602458954,dog-walk,607,ALM
116,1450000,2900000,2900,852.9187291433889,1450000,30656.25946879387,dog-walk,607,ALM
117,1462500,2925000,2925,866.3945013744712,1462500,30918.046934843063,dog-walk,607,ALM
118,1475000,2950000,2950,863.5457150457858,1475000,31182.318254470825,dog-walk,607,ALM
119,1487500,2975000,2975,875.7178553250636,1487500,31447.02881217003,dog-walk,607,ALM
120,1500000,3000000,3000,861.8324680938425,1500000,31709.39069700241,dog-walk,607,ALM
121,1512500,3025000,3025,849.0448132512092,1512500,31971.19983267784,dog-walk,607,ALM
122,1525000,3050000,3050,841.5341014108592,1525000,32233.885740995407,dog-walk,607,ALM
123,1537500,3075000,3075,900.1305172163986,1537500,32496.33019065857,dog-walk,607,ALM
124,1550000,3100000,3100,882.4847228022076,1550000,32758.673998355865,dog-walk,607,ALM
125,1562500,3125000,3125,842.2968502266373,1562500,33023.6965303421,dog-walk,607,ALM
126,1575000,3150000,3150,851.2608191842586,1575000,33287.42042326927,dog-walk,607,ALM
127,1587500,3175000,3175,851.4339822193895,1587500,33548.23143076897,dog-walk,607,ALM
128,1600000,3200000,3200,838.2029050639263,1600000,33810.95202088356,dog-walk,607,ALM
129,1612500,3225000,3225,818.1337197050528,1612500,34074.10755968094,dog-walk,607,ALM
130,1625000,3250000,3250,692.5317392885536,1625000,34334.24370408058,dog-walk,607,ALM
131,1637500,3275000,3275,876.3378464639424,1637500,34595.273948431015,dog-walk,607,ALM
132,1650000,3300000,3300,894.6272126083879,1650000,34856.30464363098,dog-walk,607,ALM
133,1662500,3325000,3325,886.2638922182184,1662500,35122.1749753952,dog-walk,607,ALM
134,1675000,3350000,3350,895.3130789649643,1675000,35384.64858627319,dog-walk,607,ALM
135,1687500,3375000,3375,751.0559284084496,1687500,35644.13995718956,dog-walk,607,ALM
136,1700000,3400000,3400,877.9655252347305,1700000,35903.64074444771,dog-walk,607,ALM
137,1712500,3425000,3425,889.8272390311107,1712500,36165.54512691498,dog-walk,607,ALM
138,1725000,3450000,3450,871.1041046439784,1725000,36427.933182001114,dog-walk,607,ALM
139,1737500,3475000,3475,893.0583114175488,1737500,36689.93782496452,dog-walk,607,ALM
140,1750000,3500000,3500,831.3976626468396,1750000,36950.75140166283,dog-walk,607,ALM
141,1762500,3525000,3525,785.4984294949218,1762500,37212.73669028282,dog-walk,607,ALM
142,1775000,3550000,3550,785.275951177257,1775000,37473.88652586937,dog-walk,607,ALM
143,1787500,3575000,3575,860.5552771089181,1787500,37732.55703520775,dog-walk,607,ALM
144,1800000,3600000,3600,858.0039244831196,1800000,37991.06352353096,dog-walk,607,ALM
145,1812500,3625000,3625,838.0046806854518,1812500,38250.86257433891,dog-walk,607,ALM
146,1825000,3650000,3650,899.9176325883254,1825000,38511.38688540459,dog-walk,607,ALM
147,1837500,3675000,3675,874.6214559747268,1837500,38773.610975027084,dog-walk,607,ALM
148,1850000,3700000,3700,885.9582980493273,1850000,39043.21198797226,dog-walk,607,ALM
149,1862500,3725000,3725,863.4565677436,1862500,39307.3297688961,dog-walk,607,ALM
150,1875000,3750000,3750,775.2424844291078,1875000,39570.50826191902,dog-walk,607,ALM
151,1887500,3775000,3775,868.8917915328848,1887500,39833.17158770561,dog-walk,607,ALM
152,1900000,3800000,3800,866.0474078894695,1900000,40095.978761434555,dog-walk,607,ALM
153,1912500,3825000,3825,898.3022753307463,1912500,40358.6605963707,dog-walk,607,ALM
154,1925000,3850000,3850,902.1964042772206,1925000,40618.69119286537,dog-walk,607,ALM
155,1937500,3875000,3875,820.7068478001999,1937500,40878.71464943886,dog-walk,607,ALM
156,1950000,3900000,3900,825.3046813895031,1950000,41137.93532323837,dog-walk,607,ALM
157,1962500,3925000,3925,823.355028478449,1962500,41398.68324446678,dog-walk,607,ALM
158,1975000,3950000,3950,839.9902539842785,1975000,41660.07828617096,dog-walk,607,ALM
159,1987500,3975000,3975,867.0961878962135,1987500,41920.647475242615,dog-walk,607,ALM
160,2000000,4000000,4000,863.1690809583324,2000000,42183.01014685631,dog-walk,607,ALM
161,2012500,4025000,4025,917.194407203955,2012500,42441.967473983765,dog-walk,607,ALM
162,2025000,4050000,4050,711.4622675460456,2025000,42703.47404694557,dog-walk,607,ALM
163,2037500,4075000,4075,875.9358450628336,2037500,42975.66632294655,dog-walk,607,ALM
164,2050000,4100000,4100,883.992218384384,2050000,43235.45647072792,dog-walk,607,ALM
165,2062500,4125000,4125,835.0027726056487,2062500,43496.300127506256,dog-walk,607,ALM
166,2075000,4150000,4150,844.403204808018,2075000,43756.20570397377,dog-walk,607,ALM
167,2087500,4175000,4175,886.3270848437205,2087500,44014.56650161743,dog-walk,607,ALM
168,2100000,4200000,4200,743.3360863306139,2100000,44272.28736305237,dog-walk,607,ALM
169,2112500,4225000,4225,888.3114624547483,2112500,44529.85477399826,dog-walk,607,ALM
170,2125000,4250000,4250,877.362913433409,2125000,44789.64359617233,dog-walk,607,ALM
171,2137500,4275000,4275,878.7560611047062,2137500,45049.80928230286,dog-walk,607,ALM
172,2150000,4300000,4300,797.2692444514256,2150000,45309.22520184517,dog-walk,607,ALM
173,2162500,4325000,4325,849.3006280302825,2162500,45569.55123949051,dog-walk,607,ALM
174,2175000,4350000,4350,696.2665775392692,2175000,45831.83281207085,dog-walk,607,ALM
175,2187500,4375000,4375,889.1473649400441,2187500,46091.02962756157,dog-walk,607,ALM
176,2200000,4400000,4400,862.3276662979573,2200000,46352.06446123123,dog-walk,607,ALM
177,2212500,4425000,4425,909.9069555791642,2212500,46614.340888261795,dog-walk,607,ALM
178,2225000,4450000,4450,913.7283871609663,2225000,46876.88658738136,dog-walk,607,ALM
179,2237500,4475000,4475,864.0433032624184,2237500,47136.15460848808,dog-walk,607,ALM
180,2250000,4500000,4500,828.740037778424,2250000,47396.31012892723,dog-walk,607,ALM
181,2262500,4525000,4525,824.4911653208877,2262500,47655.71945476532,dog-walk,607,ALM
182,2275000,4550000,4550,808.4887919065714,2275000,47915.43727707863,dog-walk,607,ALM
183,2287500,4575000,4575,835.3452792115379,2287500,48174.493629693985,dog-walk,607,ALM
184,2300000,4600000,4600,823.7436278871246,2300000,48433.75987434387,dog-walk,607,ALM
185,2312500,4625000,4625,912.0591067893208,2312500,48693.64899468422,dog-walk,607,ALM
186,2325000,4650000,4650,767.2417284328257,2325000,48955.081590890884,dog-walk,607,ALM
187,2337500,4675000,4675,841.8583490272456,2337500,49216.60927629471,dog-walk,607,ALM
188,2350000,4700000,4700,738.6888804425319,2350000,49478.06387448311,dog-walk,607,ALM
189,2362500,4725000,4725,837.9265940630337,2362500,49738.260192632675,dog-walk,607,ALM
190,2375000,4750000,4750,593.3797079927784,2375000,50001.51954627037,dog-walk,607,ALM
191,2387500,4775000,4775,791.7202666162564,2387500,50261.66014909744,dog-walk,607,ALM
192,2400000,4800000,4800,877.7671662245796,2400000,50526.928857564926,dog-walk,607,ALM
193,2412500,4825000,4825,611.123229379487,2412500,50792.60787701607,dog-walk,607,ALM
194,2425000,4850000,4850,530.5215622122306,2425000,51055.532964468,dog-walk,607,ALM
195,2437500,4875000,4875,726.7255144713413,2437500,51319.14563155174,dog-walk,607,ALM
196,2450000,4900000,4900,914.4960256638353,2450000,51579.070827007294,dog-walk,607,ALM
197,2462500,4925000,4925,784.347894281708,2462500,51838.144579172134,dog-walk,607,ALM
198,2475000,4950000,4950,837.2044020881604,2475000,52100.54378056526,dog-walk,607,ALM
199,2487500,4975000,4975,686.4928620908478,2487500,52362.51462554932,dog-walk,607,ALM
0,0,0,0,8.585144360535097,0,38.04738998413086,dog-walk,28,ALM
1,12500,25000,25,17.031100928818535,12500,300.98450565338135,dog-walk,28,ALM
2,25000,50000,50,12.433220712219654,25000,598.1124811172485,dog-walk,28,ALM
3,37500,75000,75,12.972908051088467,37500,893.1657965183258,dog-walk,28,ALM
4,50000,100000,100,17.710883035607146,50000,1190.1004662513733,dog-walk,28,ALM
5,62500,125000,125,6.985842718937709,62500,1495.8471841812134,dog-walk,28,ALM
6,75000,150000,150,24.662177147587393,75000,1791.1527466773987,dog-walk,28,ALM
7,87500,175000,175,19.808115576200546,87500,2077.3346984386444,dog-walk,28,ALM
8,100000,200000,200,21.769737403420542,100000,2367.6150596141815,dog-walk,28,ALM
9,112500,225000,225,23.633245155178667,112500,2665.5948779582977,dog-walk,28,ALM
10,125000,250000,250,23.45562583424649,125000,2966.467207670212,dog-walk,28,ALM
11,137500,275000,275,29.276407075778913,137500,3264.2961246967316,dog-walk,28,ALM
12,150000,300000,300,24.631361014866133,150000,3560.5651998519897,dog-walk,28,ALM
13,162500,325000,325,26.527953897909136,162500,3885.357963323593,dog-walk,28,ALM
14,175000,350000,350,15.960389376949479,175000,4177.661701917648,dog-walk,28,ALM
15,187500,375000,375,24.513769277229873,187500,4470.265159845352,dog-walk,28,ALM
16,200000,400000,400,14.63775307082955,200000,4755.417282342911,dog-walk,28,ALM
17,212500,425000,425,27.987060902733326,212500,5034.620106458664,dog-walk,28,ALM
18,225000,450000,450,49.83329851268441,225000,5316.780102968216,dog-walk,28,ALM
19,237500,475000,475,51.09554852917108,237500,5600.751720905304,dog-walk,28,ALM
20,250000,500000,500,53.246823571832465,250000,5884.774394035339,dog-walk,28,ALM
21,262500,525000,525,64.85520770797345,262500,6171.023629665375,dog-walk,28,ALM
22,275000,550000,550,52.96613252149491,275000,6456.468824148178,dog-walk,28,ALM
23,287500,575000,575,70.43776945874762,287500,6744.1629502773285,dog-walk,28,ALM
24,300000,600000,600,94.50638724071851,300000,7027.456155538559,dog-walk,28,ALM
25,312500,625000,625,112.96016934116953,312500,7314.007196187973,dog-walk,28,ALM
26,325000,650000,650,117.07221284419215,325000,7595.632380485535,dog-walk,28,ALM
27,337500,675000,675,114.41046885285,337500,7877.458650350571,dog-walk,28,ALM
28,350000,700000,700,134.32882466874557,350000,8152.032265663147,dog-walk,28,ALM
29,362500,725000,725,184.96871919569713,362500,8435.031949043274,dog-walk,28,ALM
30,375000,750000,750,179.60734637067344,375000,8718.559327363968,dog-walk,28,ALM
31,387500,775000,775,207.4417980674676,387500,9000.275386333466,dog-walk,28,ALM
32,400000,800000,800,232.48856619893132,400000,9281.726609945297,dog-walk,28,ALM
33,412500,825000,825,281.3353821483259,412500,9564.547828674316,dog-walk,28,ALM
34,425000,850000,850,278.0794411239741,425000,9847.366374969482,dog-walk,28,ALM
35,437500,875000,875,297.722685492626,437500,10129.41329073906,dog-walk,28,ALM
36,450000,900000,900,302.5773581563023,450000,10416.733674049377,dog-walk,28,ALM
37,462500,925000,925,342.83209633523694,462500,10694.400346755981,dog-walk,28,ALM
38,475000,950000,950,366.34270130739867,475000,10966.616519927979,dog-walk,28,ALM
39,487500,975000,975,311.87026030857334,487500,11251.456367492676,dog-walk,28,ALM
40,500000,1000000,1000,370.1927550976453,500000,11532.874328136444,dog-walk,28,ALM
41,512500,1025000,1025,383.0740948470211,512500,11821.811652898788,dog-walk,28,ALM
42,525000,1050000,1050,420.157405026183,525000,12104.157102108002,dog-walk,28,ALM
43,537500,1075000,1075,398.99784761520743,537500,12385.556989431381,dog-walk,28,ALM
44,550000,1100000,1100,440.01114161194937,550000,12666.410717010498,dog-walk,28,ALM
45,562500,1125000,1125,440.9741484634589,562500,12946.154890537262,dog-walk,28,ALM
46,575000,1150000,1150,473.7076394471372,575000,13226.209663629532,dog-walk,28,ALM
47,587500,1175000,1175,542.4385450557976,587500,13500.099909305573,dog-walk,28,ALM
48,600000,1200000,1200,460.6949080036511,600000,13773.265632152557,dog-walk,28,ALM
49,612500,1225000,1225,474.1902959225796,612500,14051.489300966263,dog-walk,28,ALM
50,625000,1250000,1250,421.89186368303126,625000,14334.280882120132,dog-walk,28,ALM
51,637500,1275000,1275,473.89404383167766,637500,14614.100636482239,dog-walk,28,ALM
52,650000,1300000,1300,501.3202774779813,650000,14893.112437725067,dog-walk,28,ALM
53,662500,1325000,1325,550.58055156551,662500,15173.6449072361,dog-walk,28,ALM
54,675000,1350000,1350,542.4470323887433,675000,15451.06612086296,dog-walk,28,ALM
55,687500,1375000,1375,689.925359034855,687500,15737.948640108109,dog-walk,28,ALM
56,700000,1400000,1400,511.4602820447861,700000,16019.004911899567,dog-walk,28,ALM
57,712500,1425000,1425,538.1099734655869,712500,16292.622689962387,dog-walk,28,ALM
58,725000,1450000,1450,498.82075102174065,725000,16567.841925144196,dog-walk,28,ALM
59,737500,1475000,1475,697.4883825727625,737500,16844.72947883606,dog-walk,28,ALM
60,750000,1500000,1500,716.8353692753901,750000,17121.630015850067,dog-walk,28,ALM
61,762500,1525000,1525,728.4237634867161,762500,17400.700008392334,dog-walk,28,ALM
62,775000,1550000,1550,763.3038952359942,775000,17678.30095434189,dog-walk,28,ALM
63,787500,1575000,1575,676.5341980760898,787500,17956.858013868332,dog-walk,28,ALM
64,800000,1600000,1600,643.9472843769521,800000,18234.84071946144,dog-walk,28,ALM
65,812500,1625000,1625,732.1474553565215,812500,18513.06531715393,dog-walk,28,ALM
66,825000,1650000,1650,688.5164969132895,825000,18789.677609682083,dog-walk,28,ALM
67,837500,1675000,1675,593.3063443443098,837500,19058.311559677124,dog-walk,28,ALM
68,850000,1700000,1700,678.9208387458798,850000,19333.185750246048,dog-walk,28,ALM
69,862500,1725000,1725,620.6085210417007,862500,19615.894204378128,dog-walk,28,ALM
70,875000,1750000,1750,616.0022048104215,875000,19891.662101745605,dog-walk,28,ALM
71,887500,1775000,1775,712.687486957328,887500,20166.58128786087,dog-walk,28,ALM
72,900000,1800000,1800,664.4707935027105,900000,20443.784593582153,dog-walk,28,ALM
73,912500,1825000,1825,752.8359955322853,912500,20719.95820260048,dog-walk,28,ALM
74,925000,1850000,1850,693.4533545054612,925000,20996.02342772484,dog-walk,28,ALM
75,937500,1875000,1875,741.4432230294206,937500,21273.548232793808,dog-walk,28,ALM
76,950000,1900000,1900,641.8728435331337,950000,21551.168965101242,dog-walk,28,ALM
77,962500,1925000,1925,763.5096502887515,962500,21820.11142730713,dog-walk,28,ALM
78,975000,1950000,1950,744.776154949987,975000,22091.11238217354,dog-walk,28,ALM
79,987500,1975000,1975,807.6228649099023,987500,22366.225462675095,dog-walk,28,ALM
80,1000000,2000000,2000,617.6533842457814,1000000,22642.96661043167,dog-walk,28,ALM
81,1012500,2025000,2025,785.234120054276,1012500,22920.028923749924,dog-walk,28,ALM
82,1025000,2050000,2050,800.7573561641674,1025000,23201.717080831528,dog-walk,28,ALM
83,1037500,2075000,2075,577.1022028545282,1037500,23485.798672676086,dog-walk,28,ALM
84,1050000,2100000,2100,669.1906595608168,1050000,23762.685371637344,dog-walk,28,ALM
85,1062500,2125000,2125,619.078319789184,1062500,24040.433289527893,dog-walk,28,ALM
86,1075000,2150000,2150,798.3194171465307,1075000,24315.051226854324,dog-walk,28,ALM
87,1087500,2175000,2175,837.5357374178895,1087500,24584.126287937164,dog-walk,28,ALM
88,1100000,2200000,2200,791.9421962007218,1100000,24854.524840593338,dog-walk,28,ALM
89,1112500,2225000,2225,808.3941162250458,1112500,25131.145914793015,dog-walk,28,ALM
90,1125000,2250000,2250,736.7921540764212,1125000,25407.580342531204,dog-walk,28,ALM
91,1137500,2275000,2275,773.6117990365972,1137500,25685.257257461548,dog-walk,28,ALM
92,1150000,2300000,2300,824.8124635210639,1150000,25967.561529636383,dog-walk,28,ALM
93,1162500,2325000,2325,729.1712022560503,1162500,26246.19134259224,dog-walk,28,ALM
94,1175000,2350000,2350,782.9344723978893,1175000,26525.26201081276,dog-walk,28,ALM
95,1187500,2375000,2375,816.6311770703321,1187500,26802.995347976685,dog-walk,28,ALM
96,1200000,2400000,2400,811.9922227824993,1200000,27080.034362077713,dog-walk,28,ALM
97,1212500,2425000,2425,652.8747819476356,1212500,27355.829234600067,dog-walk,28,ALM
98,1225000,2450000,2450,732.8606705378022,1225000,27622.72785925865,dog-walk,28,ALM
99,1237500,2475000,2475,707.5002030454523,1237500,27899.571917772293,dog-walk,28,ALM
100,1250000,2500000,2500,827.457343171152,1250000,28177.86816382408,dog-walk,28,ALM
101,1262500,2525000,2525,788.456933219896,1262500,28456.647876262665,dog-walk,28,ALM
102,1275000,2550000,2550,873.1519878791905,1275000,28733.323287010193,dog-walk,28,ALM
103,1287500,2575000,2575,832.4860762312879,1287500,29012.465098381042,dog-walk,28,ALM
104,1300000,2600000,2600,827.0762143089394,1300000,29290.116973876953,dog-walk,28,ALM
105,1312500,2625000,2625,859.4760999367734,1312500,29571.12669801712,dog-walk,28,ALM
106,1325000,2650000,2650,807.667253230964,1325000,29854.16897535324,dog-walk,28,ALM
107,1337500,2675000,2675,807.2909526761293,1337500,30131.901434659958,dog-walk,28,ALM
108,1350000,2700000,2700,745.7077251921016,1350000,30405.778450012207,dog-walk,28,ALM
109,1362500,2725000,2725,786.8517714118309,1362500,30691.10782957077,dog-walk,28,ALM
110,1375000,2750000,2750,846.5188434111108,1375000,30971.53559279442,dog-walk,28,ALM
111,1387500,2775000,2775,859.2226958084982,1387500,31253.69867014885,dog-walk,28,ALM
112,1400000,2800000,2800,825.139519659939,1400000,31529.141884326935,dog-walk,28,ALM
113,1412500,2825000,2825,890.859810077518,1412500,31806.24370241165,dog-walk,28,ALM
114,1425000,2850000,2850,900.6671683096371,1425000,32083.5807595253,dog-walk,28,ALM
115,1437500,2875000,2875,873.4971583696757,1437500,32360.097147226334,dog-walk,28,ALM
116,1450000,2900000,2900,918.9161813402161,1450000,32637.350299596786,dog-walk,28,ALM
117,1462500,2925000,2925,878.7161847079906,1462500,32907.278424263,dog-walk,28,ALM
118,1475000,2950000,2950,910.6388494101886,1475000,33180.53994321823,dog-walk,28,ALM
119,1487500,2975000,2975,880.4254083686276,1487500,33458.58614587784,dog-walk,28,ALM
120,1500000,3000000,3000,765.189875130068,1500000,33735.321606874466,dog-walk,28,ALM
121,1512500,3025000,3025,789.7052705649583,1512500,34013.61351966858,dog-walk,28,ALM
122,1525000,3050000,3050,854.7908509448423,1525000,34294.02031326294,dog-walk,28,ALM
123,1537500,3075000,3075,904.5934202248006,1537500,34571.96192026138,dog-walk,28,ALM
124,1550000,3100000,3100,856.7076849566638,1550000,34849.156291007996,dog-walk,28,ALM
125,1562500,3125000,3125,878.127459849418,1562500,35133.76697182655,dog-walk,28,ALM
126,1575000,3150000,3150,842.7852842286451,1575000,35414.09327864647,dog-walk,28,ALM
127,1587500,3175000,3175,850.9455317246072,1587500,35686.725012779236,dog-walk,28,ALM
128,1600000,3200000,3200,822.3768371911186,1600000,35959.98478603363,dog-walk,28,ALM
129,1612500,3225000,3225,859.9691932631631,1612500,36239.04546093941,dog-walk,28,ALM
130,1625000,3250000,3250,873.2518538539185,1625000,36516.812940597534,dog-walk,28,ALM
131,1637500,3275000,3275,880.5806468865073,1637500,36796.12059903145,dog-walk,28,ALM
132,1650000,3300000,3300,898.0995883231187,1650000,37073.48042845726,dog-walk,28,ALM
133,1662500,3325000,3325,880.2759624685344,1662500,37351.286603450775,dog-walk,28,ALM
134,1675000,3350000,3350,820.6896315640503,1675000,37628.55664086342,dog-walk,28,ALM
135,1687500,3375000,3375,865.4605898104392,1687500,37907.25549387932,dog-walk,28,ALM
136,1700000,3400000,3400,888.4548174543188,1700000,38183.87052989006,dog-walk,28,ALM
137,1712500,3425000,3425,842.8646296448745,1712500,38460.54724931717,dog-walk,28,ALM
138,1725000,3450000,3450,900.7041901339265,1725000,38739.687427043915,dog-walk,28,ALM
139,1737500,3475000,3475,902.5924885850396,1737500,39019.74291944504,dog-walk,28,ALM
140,1750000,3500000,3500,874.6667386814124,1750000,39299.522112846375,dog-walk,28,ALM
141,1762500,3525000,3525,863.2508230925739,1762500,39578.503752708435,dog-walk,28,ALM
142,1775000,3550000,3550,918.6127102597517,1775000,39854.231930971146,dog-walk,28,ALM
143,1787500,3575000,3575,895.620732160248,1787500,40131.36258125305,dog-walk,28,ALM
144,1800000,3600000,3600,837.7892754095817,1800000,40408.05525922775,dog-walk,28,ALM
145,1812500,3625000,3625,900.841384084945,1812500,40686.87096810341,dog-walk,28,ALM
146,1825000,3650000,3650,875.9663914133246,1825000,40961.31804704666,dog-walk,28,ALM
147,1837500,3675000,3675,878.3819369592062,1837500,41235.747717380524,dog-walk,28,ALM
148,1850000,3700000,3700,631.7368762001246,1850000,41514.53456377983,dog-walk,28,ALM
149,1862500,3725000,3725,727.7118033407971,1862500,41792.692422151566,dog-walk,28,ALM
150,1875000,3750000,3750,851.2275749622147,1875000,42075.38105797768,dog-walk,28,ALM
151,1887500,3775000,3775,897.8247848584278,1887500,42354.09068465233,dog-walk,28,ALM
152,1900000,3800000,3800,870.7707236213016,1900000,42632.96706318855,dog-walk,28,ALM
153,1912500,3825000,3825,868.3347148942424,1912500,42911.68578195572,dog-walk,28,ALM
154,1925000,3850000,3850,898.3421917268806,1925000,43192.64237856865,dog-walk,28,ALM
155,1937500,3875000,3875,877.9834731870617,1937500,43474.310859918594,dog-walk,28,ALM
156,1950000,3900000,3900,757.5469920979806,1950000,43753.10756397247,dog-walk,28,ALM
157,1962500,3925000,3925,836.7101040289328,1962500,44025.201156139374,dog-walk,28,ALM
158,1975000,3950000,3950,889.2372470211856,1975000,44302.1715464592,dog-walk,28,ALM
159,1987500,3975000,3975,901.9554216326194,1987500,44577.43174743652,dog-walk,28,ALM
160,2000000,4000000,4000,891.2475219578577,2000000,44853.92752957344,dog-walk,28,ALM
161,2012500,4025000,4025,801.600488827234,2012500,45132.46406173706,dog-walk,28,ALM
162,2025000,4050000,4050,744.418525771158,2025000,45411.0046081543,dog-walk,28,ALM
163,2037500,4075000,4075,885.5046464401485,2037500,45688.614300489426,dog-walk,28,ALM
164,2050000,4100000,4100,682.3151602128968,2050000,45966.40137696266,dog-walk,28,ALM
165,2062500,4125000,4125,804.0992385591887,2062500,46245.46150016785,dog-walk,28,ALM
166,2075000,4150000,4150,760.5179549084985,2075000,46522.58956027031,dog-walk,28,ALM
167,2087500,4175000,4175,736.8342538566937,2087500,46796.90023112297,dog-walk,28,ALM
168,2100000,4200000,4200,864.8522960454417,2100000,47082.82974433899,dog-walk,28,ALM
169,2112500,4225000,4225,869.1786872934512,2112500,47360.388707876205,dog-walk,28,ALM
170,2125000,4250000,4250,852.6555289265447,2125000,47637.99613904953,dog-walk,28,ALM
171,2137500,4275000,4275,873.2027651149492,2137500,47914.42869210243,dog-walk,28,ALM
172,2150000,4300000,4300,800.8680965351014,2150000,48187.46484327316,dog-walk,28,ALM
173,2162500,4325000,4325,753.5436883384865,2162500,48464.14666008949,dog-walk,28,ALM
174,2175000,4350000,4350,869.4345224319395,2175000,48737.05950021744,dog-walk,28,ALM
175,2187500,4375000,4375,931.8435815190123,2187500,49008.67043066025,dog-walk,28,ALM
176,2200000,4400000,4400,932.5588066547127,2200000,49279.43393325806,dog-walk,28,ALM
177,2212500,4425000,4425,785.6251027560663,2212500,49549.156685590744,dog-walk,28,ALM
178,2225000,4450000,4450,865.3161692000506,2225000,49824.08655285835,dog-walk,28,ALM
179,2237500,4475000,4475,816.6139555006424,2237500,50104.97987508774,dog-walk,28,ALM
180,2250000,4500000,4500,906.8512753574723,2250000,50379.94660782814,dog-walk,28,ALM
181,2262500,4525000,4525,890.9917042079157,2262500,50653.968517541885,dog-walk,28,ALM
182,2275000,4550000,4550,876.2810991534949,2275000,50930.26725316048,dog-walk,28,ALM
183,2287500,4575000,4575,933.5536550588744,2287500,51202.15021300316,dog-walk,28,ALM
184,2300000,4600000,4600,904.3938271989055,2300000,51474.28054714203,dog-walk,28,ALM
185,2312500,4625000,4625,920.0161715442694,2312500,51743.906445264816,dog-walk,28,ALM
186,2325000,4650000,4650,898.0520942437279,2325000,52015.33740234375,dog-walk,28,ALM
187,2337500,4675000,4675,906.0195215860138,2337500,52285.02473306656,dog-walk,28,ALM
188,2350000,4700000,4700,865.3139781841764,2350000,52558.99648189545,dog-walk,28,ALM
189,2362500,4725000,4725,819.5238574832017,2362500,52833.740263700485,dog-walk,28,ALM
190,2375000,4750000,4750,884.0819651864992,2375000,53104.370918512344,dog-walk,28,ALM
191,2387500,4775000,4775,876.0046705378036,2387500,53375.030366659164,dog-walk,28,ALM
192,2400000,4800000,4800,904.3010010357042,2400000,53645.991667985916,dog-walk,28,ALM
193,2412500,4825000,4825,858.7077675545324,2412500,53916.156128168106,dog-walk,28,ALM
194,2425000,4850000,4850,918.7403953790108,2425000,54187.78986668587,dog-walk,28,ALM
195,2437500,4875000,4875,723.2692161286775,2437500,54467.09760570526,dog-walk,28,ALM
196,2450000,4900000,4900,874.7518791085843,2450000,54742.36416530609,dog-walk,28,ALM
197,2462500,4925000,4925,916.0225315312118,2462500,55014.25401139259,dog-walk,28,ALM
198,2475000,4950000,4950,766.486974632945,2475000,55285.99865293503,dog-walk,28,ALM
199,2487500,4975000,4975,876.3786515897389,2487500,55559.28526496887,dog-walk,28,ALM
0,0,0,0,8.735945426568254,0,33.61128640174866,dog-walk,160,ALM
1,12500,25000,25,6.230668034122612,12500,282.0734417438507,dog-walk,160,ALM
2,25000,50000,50,11.513499376279439,25000,561.5733697414398,dog-walk,160,ALM
3,37500,75000,75,15.629430271330232,37500,843.2147059440613,dog-walk,160,ALM
4,50000,100000,100,13.437437849284626,50000,1124.1812376976013,dog-walk,160,ALM
5,62500,125000,125,11.475959646279325,62500,1396.8339259624481,dog-walk,160,ALM
6,75000,150000,150,10.171895276512501,75000,1676.1148688793182,dog-walk,160,ALM
7,87500,175000,175,14.670186774774189,87500,1960.7845685482025,dog-walk,160,ALM
8,100000,200000,200,19.187115152995,100000,2244.947865486145,dog-walk,160,ALM
9,112500,225000,225,13.234839897698574,112500,2527.489692211151,dog-walk,160,ALM
10,125000,250000,250,11.4040161817283,125000,2806.310272216797,dog-walk,160,ALM
11,137500,275000,275,6.57158178854265,137500,3083.529158592224,dog-walk,160,ALM
12,150000,300000,300,24.845280224341845,150000,3355.526013612747,dog-walk,160,ALM
13,162500,325000,325,14.45715458018434,162500,3630.224186897278,dog-walk,160,ALM
14,175000,350000,350,29.233699538386738,175000,3903.861330509186,dog-walk,160,ALM
15,187500,375000,375,25.68715887452988,187500,4170.737122297287,dog-walk,160,ALM
16,200000,400000,400,30.417075150322113,200000,4439.351439237595,dog-walk,160,ALM
17,212500,425000,425,22.164531411799477,212500,4710.723024129868,dog-walk,160,ALM
18,225000,450000,450,28.26423931015559,225000,4980.533065795898,dog-walk,160,ALM
19,237500,475000,475,34.18564819151894,237500,5248.237466573715,dog-walk,160,ALM
20,250000,500000,500,14.783653930811559,250000,5513.947480201721,dog-walk,160,ALM
21,262500,525000,525,65.50057214711329,262500,5786.363237142563,dog-walk,160,ALM
22,275000,550000,550,11.854565892730397,275000,6053.993452548981,dog-walk,160,ALM
23,287500,575000,575,60.345130452559,287500,6321.432936429977,dog-walk,160,ALM
24,300000,600000,600,29.540956863423787,300000,6588.097175836563,dog-walk,160,ALM
25,312500,625000,625,68.15920672641629,312500,6853.692679405212,dog-walk,160,ALM
26,325000,650000,650,96.217443543831,325000,7118.498262166977,dog-walk,160,ALM
27,337500,675000,675,122.4796214553306,337500,7383.721792221069,dog-walk,160,ALM
28,350000,700000,700,101.91127613642145,350000,7648.448488950729,dog-walk,160,ALM
29,362500,725000,725,140.64393835839036,362500,7914.263944387436,dog-walk,160,ALM
30,375000,750000,750,188.69138721237542,375000,8179.255424499512,dog-walk,160,ALM
31,387500,775000,775,230.7772070386897,387500,8444.583914995193,dog-walk,160,ALM
32,400000,800000,800,254.9456726531399,400000,8710.544309854507,dog-walk,160,ALM
33,412500,825000,825,247.6954264936122,412500,8975.240728139877,dog-walk,160,ALM
34,425000,850000,850,267.9594768363651,425000,9239.37193274498,dog-walk,160,ALM
35,437500,875000,875,289.16416805110214,437500,9505.47962474823,dog-walk,160,ALM
36,450000,900000,900,277.65658476189,450000,9780.635284662247,dog-walk,160,ALM
37,462500,925000,925,298.20026127823394,462500,10046.620966911316,dog-walk,160,ALM
38,475000,950000,950,350.90096489006754,475000,10311.135894298553,dog-walk,160,ALM
39,487500,975000,975,390.07604453918873,487500,10577.188160419464,dog-walk,160,ALM
40,500000,1000000,1000,374.2052786781642,500000,10840.210503578186,dog-walk,160,ALM
41,512500,1025000,1025,403.0015051351198,512500,11105.264871120453,dog-walk,160,ALM
42,525000,1050000,1050,414.38303090671263,525000,11370.731269359589,dog-walk,160,ALM
43,537500,1075000,1075,386.8285660156943,537500,11635.798905134201,dog-walk,160,ALM
44,550000,1100000,1100,347.0510851197138,550000,11953.489742994308,dog-walk,160,ALM
45,562500,1125000,1125,463.99765347539744,562500,12217.147327661514,dog-walk,160,ALM
46,575000,1150000,1150,423.2192881658064,575000,12483.210450649261,dog-walk,160,ALM
47,587500,1175000,1175,433.5868293637806,587500,12748.905095100403,dog-walk,160,ALM
48,600000,1200000,1200,427.91652304724323,600000,13016.154433012009,dog-walk,160,ALM
49,612500,1225000,1225,430.5883392199545,612500,13284.283783912659,dog-walk,160,ALM
50,625000,1250000,1250,392.93235733499915,625000,13553.341533660889,dog-walk,160,ALM
51,637500,1275000,1275,409.47955435780034,637500,13821.55698800087,dog-walk,160,ALM
52,650000,1300000,1300,462.9774395096688,650000,14086.91209244728,dog-walk,160,ALM
53,662500,1325000,1325,450.6144586154317,662500,14353.33009648323,dog-walk,160,ALM
54,675000,1350000,1350,446.08037131119875,675000,14620.51939868927,dog-walk,160,ALM
55,687500,1375000,1375,497.43475823829647,687500,14887.589428424835,dog-walk,160,ALM
56,700000,1400000,1400,499.4359126324991,700000,15155.104415416718,dog-walk,160,ALM
57,712500,1425000,1425,515.3813505345792,712500,15421.273223400116,dog-walk,160,ALM
58,725000,1450000,1450,500.9846394489947,725000,15688.895005464554,dog-walk,160,ALM
59,737500,1475000,1475,521.5092341561442,737500,15955.107342243195,dog-walk,160,ALM
60,750000,1500000,1500,500.35001657697967,750000,16221.312680244446,dog-walk,160,ALM
61,762500,1525000,1525,559.7735523403937,762500,16493.492097854614,dog-walk,160,ALM
62,775000,1550000,1550,534.7607358850316,775000,16758.346880197525,dog-walk,160,ALM
63,787500,1575000,1575,564.7006358738254,787500,17023.222434043884,dog-walk,160,ALM
64,800000,1600000,1600,561.7910125541533,800000,17288.214935064316,dog-walk,160,ALM
65,812500,1625000,1625,531.1024823603166,812500,17553.391531944275,dog-walk,160,ALM
66,825000,1650000,1650,547.8003986115891,825000,17817.369891166687,dog-walk,160,ALM
67,837500,1675000,1675,544.276416032411,837500,18086.16618514061,dog-walk,160,ALM
68,850000,1700000,1700,553.896027055913,850000,18352.059935569763,dog-walk,160,ALM
69,862500,1725000,1725,575.3967088007532,862500,18615.384283304214,dog-walk,160,ALM
70,875000,1750000,1750,554.7997811561246,875000,18879.218376159668,dog-walk,160,ALM
71,887500,1775000,1775,612.7744928990812,887500,19141.34699654579,dog-walk,160,ALM
72,900000,1800000,1800,598.9105560866586,900000,19404.85686826706,dog-walk,160,ALM
73,912500,1825000,1825,521.116380123425,912500,19668.751919984818,dog-walk,160,ALM
74,925000,1850000,1850,508.4776581036557,925000,19932.50675225258,dog-walk,160,ALM
75,937500,1875000,1875,585.3303845000867,937500,20195.509946346283,dog-walk,160,ALM
76,950000,1900000,1900,596.0685781235995,950000,20457.638016223907,dog-walk,160,ALM
77,962500,1925000,1925,612.4423490814042,962500,20720.996553897858,dog-walk,160,ALM
78,975000,1950000,1950,617.8401827967342,975000,20984.769047498703,dog-walk,160,ALM
79,987500,1975000,1975,570.349679893085,987500,21248.720636606216,dog-walk,160,ALM
80,1000000,2000000,2000,602.7128767874223,1000000,21512.41465115547,dog-walk,160,ALM
81,1012500,2025000,2025,621.1706154213886,1012500,21777.98873448372,dog-walk,160,ALM
82,1025000,2050000,2050,657.554056530654,1025000,22045.565375566483,dog-walk,160,ALM
83,1037500,2075000,2075,602.039097187956,1037500,22308.85923886299,dog-walk,160,ALM
84,1050000,2100000,2100,556.8129425387979,1050000,22572.65381383896,dog-walk,160,ALM
85,1062500,2125000,2125,567.9153686043315,1062500,22836.13498711586,dog-walk,160,ALM
86,1075000,2150000,2150,599.5241449737925,1075000,23100.80379462242,dog-walk,160,ALM
87,1087500,2175000,2175,618.7891271943099,1087500,23365.953359127045,dog-walk,160,ALM
88,1100000,2200000,2200,610.5888563227339,1100000,23629.75631737709,dog-walk,160,ALM
89,1112500,2225000,2225,533.9798138456929,1112500,23893.561872005463,dog-walk,160,ALM
90,1125000,2250000,2250,623.371771644131,1125000,24159.031811475754,dog-walk,160,ALM
91,1137500,2275000,2275,655.5703487916661,1137500,24422.414232969284,dog-walk,160,ALM
92,1150000,2300000,2300,567.9149257725635,1150000,24687.430624485016,dog-walk,160,ALM
93,1162500,2325000,2325,535.8561469611507,1162500,24952.49404168129,dog-walk,160,ALM
94,1175000,2350000,2350,670.3522718819908,1175000,25217.47460603714,dog-walk,160,ALM
95,1187500,2375000,2375,654.1584776389434,1187500,25482.07924413681,dog-walk,160,ALM
96,1200000,2400000,2400,642.8633155852866,1200000,25748.68459868431,dog-walk,160,ALM
97,1212500,2425000,2425,649.3410007186249,1212500,26017.85635662079,dog-walk,160,ALM
98,1225000,2450000,2450,596.4102179441664,1225000,26282.080860853195,dog-walk,160,ALM
99,1237500,2475000,2475,609.8398796641642,1237500,26545.935153007507,dog-walk,160,ALM
100,1250000,2500000,2500,723.0145664598219,1250000,26809.139060497284,dog-walk,160,ALM
101,1262500,2525000,2525,738.9542250993575,1262500,27071.106595993042,dog-walk,160,ALM
102,1275000,2550000,2550,727.873840324463,1275000,27333.08680677414,dog-walk,160,ALM
103,1287500,2575000,2575,712.2732644357194,1287500,27595.137617588043,dog-walk,160,ALM
104,1300000,2600000,2600,824.3425641391259,1300000,27856.310188293457,dog-walk,160,ALM
105,1312500,2625000,2625,793.1933240420378,1312500,28118.28950715065,dog-walk,160,ALM
106,1325000,2650000,2650,762.0799838953006,1325000,28379.112122774124,dog-walk,160,ALM
107,1337500,2675000,2675,840.7381151213901,1337500,28640.517972946167,dog-walk,160,ALM
108,1350000,2700000,2700,803.4266053736889,1350000,28902.40259361267,dog-walk,160,ALM
109,1362500,2725000,2725,911.1366747562836,1362500,29163.1312789917,dog-walk,160,ALM
110,1375000,2750000,2750,825.8855455506051,1375000,29423.271737098694,dog-walk,160,ALM
111,1387500,2775000,2775,776.1423160174239,1387500,29682.731133699417,dog-walk,160,ALM
112,1400000,2800000,2800,688.9078895710775,1400000,29952.34875392914,dog-walk,160,ALM
113,1412500,2825000,2825,773.0134911629661,1412500,30213.42724084854,dog-walk,160,ALM
114,1425000,2850000,2850,825.5035138666941,1425000,30474.245535850525,dog-walk,160,ALM
115,1437500,2875000,2875,842.0117999438091,1437500,30737.496434688568,dog-walk,160,ALM
116,1450000,2900000,2900,851.4979354701925,1450000,31000.533856391907,dog-walk,160,ALM
117,1462500,2925000,2925,853.2843595794787,1462500,31262.799917936325,dog-walk,160,ALM
118,1475000,2950000,2950,810.9048174450269,1475000,31524.87943148613,dog-walk,160,ALM
119,1487500,2975000,2975,860.042274000675,1487500,31787.671476364136,dog-walk,160,ALM
120,1500000,3000000,3000,826.1813870819554,1500000,32051.50259900093,dog-walk,160,ALM
121,1512500,3025000,3025,760.5548341139139,1512500,32318.07459616661,dog-walk,160,ALM
122,1525000,3050000,3050,840.4013454853233,1525000,32582.3141040802,dog-walk,160,ALM
123,1537500,3075000,3075,834.648261795357,1537500,32844.2444562912,dog-walk,160,ALM
124,1550000,3100000,3100,760.9186412205852,1550000,33106.026030778885,dog-walk,160,ALM
125,1562500,3125000,3125,666.9579578889334,1562500,33366.97614240646,dog-walk,160,ALM
126,1575000,3150000,3150,760.0578417086309,1575000,33628.73713374138,dog-walk,160,ALM
127,1587500,3175000,3175,889.2868298617921,1587500,33898.159210920334,dog-walk,160,ALM
128,1600000,3200000,3200,868.8932017078434,1600000,34159.26512718201,dog-walk,160,ALM
129,1612500,3225000,3225,883.8533396981433,1612500,34422.05309820175,dog-walk,160,ALM
130,1625000,3250000,3250,884.2160126709992,1625000,34682.57985973358,dog-walk,160,ALM
131,1637500,3275000,3275,881.1103995727711,1637500,34943.02977991104,dog-walk,160,ALM
132,1650000,3300000,3300,892.6073028786097,1650000,35202.38435459137,dog-walk,160,ALM
133,1662500,3325000,3325,766.5381994818744,1662500,35462.10203742981,dog-walk,160,ALM
134,1675000,3350000,3350,912.7791130038564,1675000,35721.73165893555,dog-walk,160,ALM
135,1687500,3375000,3375,877.4718091479821,1687500,35980.4691426754,dog-walk,160,ALM
136,1700000,3400000,3400,902.7240729658575,1700000,36238.801612615585,dog-walk,160,ALM
137,1712500,3425000,3425,898.4943276863248,1712500,36496.41768717766,dog-walk,160,ALM
138,1725000,3450000,3450,843.066669252162,1725000,36755.08134388924,dog-walk,160,ALM
139,1737500,3475000,3475,894.6900824611051,1737500,37013.78726887703,dog-walk,160,ALM
140,1750000,3500000,3500,869.6237718716566,1750000,37272.63319015503,dog-walk,160,ALM
141,1762500,3525000,3525,848.3446059916221,1762500,37533.415331840515,dog-walk,160,ALM
142,1775000,3550000,3550,877.8658933494793,1775000,37801.84272933006,dog-walk,160,ALM
143,1787500,3575000,3575,831.4081700765057,1787500,38061.149465084076,dog-walk,160,ALM
144,1800000,3600000,3600,820.6615444934032,1800000,38319.48933506012,dog-walk,160,ALM
145,1812500,3625000,3625,763.2467489206571,1812500,38578.2621076107,dog-walk,160,ALM
146,1825000,3650000,3650,870.537801489756,1825000,38838.303859472275,dog-walk,160,ALM
147,1837500,3675000,3675,894.9252312863675,1837500,39098.32967686653,dog-walk,160,ALM
148,1850000,3700000,3700,917.0875562904378,1850000,39356.694855451584,dog-walk,160,ALM
149,1862500,3725000,3725,900.9252553827976,1862500,39614.89674830437,dog-walk,160,ALM
150,1875000,3750000,3750,861.6263487228982,1875000,39874.33813095093,dog-walk,160,ALM
151,1887500,3775000,3775,883.4224178478795,1887500,40137.75728750229,dog-walk,160,ALM
152,1900000,3800000,3800,797.8855810551853,1900000,40400.80262041092,dog-walk,160,ALM
153,1912500,3825000,3825,906.2208633178246,1912500,40659.34793496132,dog-walk,160,ALM
154,1925000,3850000,3850,838.0467577846503,1925000,40918.48099708557,dog-walk,160,ALM
155,1937500,3875000,3875,903.3883144830227,1937500,41177.759370565414,dog-walk,160,ALM
156,1950000,3900000,3900,931.0138427118197,1950000,41438.285651922226,dog-walk,160,ALM
157,1962500,3925000,3925,929.8807566920019,1962500,41702.07039618492,dog-walk,160,ALM
158,1975000,3950000,3950,869.2913477226891,1975000,41961.56931018829,dog-walk,160,ALM
159,1987500,3975000,3975,904.0427461308706,1987500,42221.5598628521,dog-walk,160,ALM
160,2000000,4000000,4000,886.0350717635313,2000000,42479.99708151817,dog-walk,160,ALM
161,2012500,4025000,4025,911.1115010638662,2012500,42737.76783108711,dog-walk,160,ALM
162,2025000,4050000,4050,899.4219967746587,2025000,42995.98945713043,dog-walk,160,ALM
163,2037500,4075000,4075,770.4105861939589,2037500,43254.850343465805,dog-walk,160,ALM
164,2050000,4100000,4100,884.5140911445876,2050000,43513.158856630325,dog-walk,160,ALM
165,2062500,4125000,4125,882.9094864375469,2062500,43769.43639135361,dog-walk,160,ALM
166,2075000,4150000,4150,823.7664788804137,2075000,44027.26375246048,dog-walk,160,ALM
167,2087500,4175000,4175,874.7762476606201,2087500,44285.69701528549,dog-walk,160,ALM
168,2100000,4200000,4200,822.5968616765988,2100000,44544.03703546524,dog-walk,160,ALM
169,2112500,4225000,4225,765.1433489772328,2112500,44800.87987279892,dog-walk,160,ALM
170,2125000,4250000,4250,745.7197765358011,2125000,45058.95463132858,dog-walk,160,ALM
171,2137500,4275000,4275,908.5721579487148,2137500,45319.45541357994,dog-walk,160,ALM
172,2150000,4300000,4300,829.6866042681737,2150000,45584.36163640022,dog-walk,160,ALM
173,2162500,4325000,4325,768.3515781529175,2162500,45845.4241297245,dog-walk,160,ALM
174,2175000,4350000,4350,860.5803754966051,2175000,46106.366449832916,dog-walk,160,ALM
175,2187500,4375000,4375,812.8972574659264,2187500,46367.846421957016,dog-walk,160,ALM
176,2200000,4400000,4400,895.6320617369832,2200000,46628.71092772484,dog-walk,160,ALM
177,2212500,4425000,4425,819.980354606391,2212500,46889.53483629227,dog-walk,160,ALM
178,2225000,4450000,4450,588.2096203468275,2225000,47149.391169309616,dog-walk,160,ALM
179,2237500,4475000,4475,843.871919352477,2237500,47411.03286910057,dog-walk,160,ALM
180,2250000,4500000,4500,787.9328574443036,2250000,47670.80330634117,dog-walk,160,ALM
181,2262500,4525000,4525,852.4956040658466,2262500,47931.08807849884,dog-walk,160,ALM
182,2275000,4550000,4550,865.7742472116295,2275000,48191.8198697567,dog-walk,160,ALM
183,2287500,4575000,4575,899.6217585718293,2287500,48452.84846138954,dog-walk,160,ALM
184,2300000,4600000,4600,916.3739338171542,2300000,48713.55721759796,dog-walk,160,ALM
185,2312500,4625000,4625,798.1565090946426,2312500,48975.66291022301,dog-walk,160,ALM
186,2325000,4650000,4650,732.6837421058358,2325000,49239.509806871414,dog-walk,160,ALM
187,2337500,4675000,4675,812.0034822603675,2337500,49511.59622001648,dog-walk,160,ALM
188,2350000,4700000,4700,849.7217154399989,2350000,49772.252907037735,dog-walk,160,ALM
189,2362500,4725000,4725,929.8802001183897,2362500,50033.15194749832,dog-walk,160,ALM
190,2375000,4750000,4750,853.2021115065629,2375000,50292.91366362572,dog-walk,160,ALM
191,2387500,4775000,4775,767.9945460500569,2387500,50553.2505505085,dog-walk,160,ALM
192,2400000,4800000,4800,850.1091447797119,2400000,50812.48739147186,dog-walk,160,ALM
193,2412500,4825000,4825,816.3428621967514,2412500,51071.631710767746,dog-walk,160,ALM
194,2425000,4850000,4850,589.6634666384007,2425000,51331.84847617149,dog-walk,160,ALM
195,2437500,4875000,4875,763.9005809397729,2437500,51591.57744240761,dog-walk,160,ALM
196,2450000,4900000,4900,843.572096487607,2450000,51850.16284418106,dog-walk,160,ALM
197,2462500,4925000,4925,881.7037549426411,2462500,52109.949811697006,dog-walk,160,ALM
198,2475000,4950000,4950,828.996492957378,2475000,52371.17205739021,dog-walk,160,ALM
199,2487500,4975000,4975,636.4623973937686,2487500,52634.026220321655,dog-walk,160,ALM
0,0,0,0,4.5385413188712045,0,36.86454772949219,dog-run,451,ALM
1,12500,25000,25,7.641140384230856,12500,283.1168169975281,dog-run,451,ALM
2,25000,50000,50,6.6035131228575,25000,569.3861117362976,dog-run,451,ALM
3,37500,75000,75,9.003308098401316,37500,856.6215636730194,dog-run,451,ALM
4,50000,100000,100,12.01271046905995,50000,1144.191282749176,dog-run,451,ALM
5,62500,125000,125,8.881489253117516,62500,1436.1935546398163,dog-run,451,ALM
6,75000,150000,150,18.685425843457132,75000,1720.9086163043976,dog-run,451,ALM
7,87500,175000,175,10.722907597681337,87500,2003.8015868663788,dog-run,451,ALM
8,100000,200000,200,5.979541429290852,100000,2290.9266192913055,dog-run,451,ALM
9,112500,225000,225,4.263264722097849,112500,2578.0009593963623,dog-run,451,ALM
10,125000,250000,250,13.010060519173482,125000,2859.3131444454193,dog-run,451,ALM
11,137500,275000,275,8.609030169591588,137500,3140.42205119133,dog-run,451,ALM
12,150000,300000,300,4.867618648553707,150000,3419.420786380768,dog-run,451,ALM
13,162500,325000,325,5.898609723566796,162500,3699.1803822517395,dog-run,451,ALM
14,175000,350000,350,6.300392208673742,175000,3993.1819274425507,dog-run,451,ALM
15,187500,375000,375,6.855916776080996,187500,4265.929517030716,dog-run,451,ALM
16,200000,400000,400,8.368534005212094,200000,4536.095368385315,dog-run,451,ALM
17,212500,425000,425,18.355919966752204,212500,4805.3780155181885,dog-run,451,ALM
18,225000,450000,450,12.863605854192755,225000,5074.149167537689,dog-run,451,ALM
19,237500,475000,475,21.43125997741617,237500,5342.275911331177,dog-run,451,ALM
20,250000,500000,500,36.19598666098943,250000,5610.807503223419,dog-run,451,ALM
21,262500,525000,525,26.056921178428997,262500,5879.258265256882,dog-run,451,ALM
22,275000,550000,550,43.89208650136055,275000,6148.4083552360535,dog-run,451,ALM
23,287500,575000,575,39.58643029734093,287500,6417.474437952042,dog-run,451,ALM
24,300000,600000,600,32.41413926330115,300000,6685.9767808914185,dog-run,451,ALM
25,312500,625000,625,29.497298967406387,312500,6956.145005226135,dog-run,451,ALM
26,325000,650000,650,67.4665396602067,325000,7226.896871328354,dog-run,451,ALM
27,337500,675000,675,64.5681797909181,337500,7499.609913825989,dog-run,451,ALM
28,350000,700000,700,59.77955039375403,350000,7775.749297380447,dog-run,451,ALM
29,362500,725000,725,84.14226361526853,362500,8049.768623113632,dog-run,451,ALM
30,375000,750000,750,68.56314038251513,375000,8321.922014951706,dog-run,451,ALM
31,387500,775000,775,46.88295448862486,387500,8594.91282916069,dog-run,451,ALM
32,400000,800000,800,42.57850267412057,400000,8865.969408988953,dog-run,451,ALM
33,412500,825000,825,72.9366996896059,412500,9133.539265155792,dog-run,451,ALM
34,425000,850000,850,62.13166267397504,425000,9401.448386669159,dog-run,451,ALM
35,437500,875000,875,49.973523687836696,437500,9668.396005630493,dog-run,451,ALM
36,450000,900000,900,37.90542032131244,450000,9934.951810598373,dog-run,451,ALM
37,462500,925000,925,60.99944660419336,462500,10200.945061683655,dog-run,451,ALM
38,475000,950000,950,53.2431910454045,475000,10466.104897022247,dog-run,451,ALM
39,487500,975000,975,55.23146903067493,487500,10737.579459428787,dog-run,451,ALM
40,500000,1000000,1000,53.111839521232014,500000,11021.130214214325,dog-run,451,ALM
41,512500,1025000,1025,72.2104026180036,512500,11300.924733161926,dog-run,451,ALM
42,525000,1050000,1050,67.83606677389352,525000,11581.386566877365,dog-run,451,ALM
43,537500,1075000,1075,64.68658334429794,537500,11866.17843580246,dog-run,451,ALM
44,550000,1100000,1100,65.65148341058998,550000,12143.630555391312,dog-run,451,ALM
45,562500,1125000,1125,60.22258968759299,562500,12413.530084609985,dog-run,451,ALM
46,575000,1150000,1150,53.85663370514044,575000,12687.63888835907,dog-run,451,ALM
47,587500,1175000,1175,62.81111780952476,587500,12965.085686683655,dog-run,451,ALM
48,600000,1200000,1200,61.76643521945292,600000,13252.5894241333,dog-run,451,ALM
49,612500,1225000,1225,56.88872084120576,612500,13537.760588645935,dog-run,451,ALM
50,625000,1250000,1250,69.61405911318192,625000,13823.77227306366,dog-run,451,ALM
51,637500,1275000,1275,64.63500120519252,637500,14105.105280160904,dog-run,451,ALM
52,650000,1300000,1300,68.02948720123513,650000,14382.183370351791,dog-run,451,ALM
53,662500,1325000,1325,59.95959337704958,662500,14670.72272491455,dog-run,451,ALM
54,675000,1350000,1350,58.154280873772905,675000,14952.068705558777,dog-run,451,ALM
55,687500,1375000,1375,62.14842792984543,687500,15241.366684436798,dog-run,451,ALM
56,700000,1400000,1400,70.47550371991898,700000,15523.479803323746,dog-run,451,ALM
57,712500,1425000,1425,73.17946583575738,712500,15802.357827425003,dog-run,451,ALM
58,725000,1450000,1450,61.79391255228536,725000,16076.373276472092,dog-run,451,ALM
59,737500,1475000,1475,70.73559501420408,737500,16353.968187093735,dog-run,451,ALM
60,750000,1500000,1500,75.36934041340655,750000,16633.25976920128,dog-run,451,ALM
61,762500,1525000,1525,75.03132020702547,762500,16903.148285627365,dog-run,451,ALM
62,775000,1550000,1550,73.58999703831778,775000,17174.668766498566,dog-run,451,ALM
63,787500,1575000,1575,68.72125664713113,787500,17443.553692102432,dog-run,451,ALM
64,800000,1600000,1600,89.10041469025529,800000,17713.933419704437,dog-run,451,ALM
65,812500,1625000,1625,95.20093446870233,812500,17985.215943336487,dog-run,451,ALM
66,825000,1650000,1650,78.16225409834816,825000,18262.672595262527,dog-run,451,ALM
67,837500,1675000,1675,84.78190766398438,837500,18535.22282934189,dog-run,451,ALM
68,850000,1700000,1700,68.67746625532955,850000,18808.68673825264,dog-run,451,ALM
69,862500,1725000,1725,84.52948005793564,862500,19080.936996221542,dog-run,451,ALM
70,875000,1750000,1750,80.44355044283698,875000,19344.98398423195,dog-run,451,ALM
71,887500,1775000,1775,97.74038533965599,887500,19611.672205924988,dog-run,451,ALM
72,900000,1800000,1800,100.23380957621062,900000,19879.761316537857,dog-run,451,ALM
73,912500,1825000,1825,164.66825022525785,912500,20147.61032295227,dog-run,451,ALM
74,925000,1850000,1850,110.37185785705307,925000,20416.67230463028,dog-run,451,ALM
75,937500,1875000,1875,156.32265333566522,937500,20687.290536880493,dog-run,451,ALM
76,950000,1900000,1900,129.72220248546284,950000,20965.34129023552,dog-run,451,ALM
77,962500,1925000,1925,186.7269215113646,962500,21236.6210668087,dog-run,451,ALM
78,975000,1950000,1950,141.1095133412061,975000,21504.22181081772,dog-run,451,ALM
79,987500,1975000,1975,187.17184874370233,987500,21767.537947416306,dog-run,451,ALM
80,1000000,2000000,2000,169.70130593660707,1000000,22035.88635444641,dog-run,451,ALM
81,1012500,2025000,2025,182.74940091675487,1012500,22309.832270860672,dog-run,451,ALM
82,1025000,2050000,2050,178.71001910641107,1025000,22581.360456705093,dog-run,451,ALM
83,1037500,2075000,2075,156.51195982707083,1037500,22851.993525266647,dog-run,451,ALM
84,1050000,2100000,2100,142.81619959407845,1050000,23122.37461042404,dog-run,451,ALM
85,1062500,2125000,2125,135.145417736719,1062500,23401.522692918777,dog-run,451,ALM
86,1075000,2150000,2150,126.85394223119313,1075000,23672.935182094574,dog-run,451,ALM
87,1087500,2175000,2175,135.5234938222438,1087500,23941.44410777092,dog-run,451,ALM
88,1100000,2200000,2200,161.87332303469117,1100000,24217.50607919693,dog-run,451,ALM
89,1112500,2225000,2225,141.72067185870145,1112500,24494.161323308945,dog-run,451,ALM
90,1125000,2250000,2250,157.56134800952952,1125000,24766.053358078003,dog-run,451,ALM
91,1137500,2275000,2275,152.92366225917158,1137500,25039.06789636612,dog-run,451,ALM
92,1150000,2300000,2300,127.22954722486482,1150000,25307.68012022972,dog-run,451,ALM
93,1162500,2325000,2325,173.0591100653163,1162500,25572.998037338257,dog-run,451,ALM
94,1175000,2350000,2350,157.93668411073244,1175000,25834.09454202652,dog-run,451,ALM
95,1187500,2375000,2375,122.04282386727975,1187500,26093.915969371796,dog-run,451,ALM
96,1200000,2400000,2400,162.19746605974265,1200000,26353.75460267067,dog-run,451,ALM
97,1212500,2425000,2425,164.8737836546796,1212500,26614.712550401688,dog-run,451,ALM
98,1225000,2450000,2450,124.75612855283427,1225000,26876.044474840164,dog-run,451,ALM
99,1237500,2475000,2475,141.80388977214974,1237500,27138.467068195343,dog-run,451,ALM
100,1250000,2500000,2500,155.5184323162831,1250000,27401.801260709763,dog-run,451,ALM
101,1262500,2525000,2525,143.34395468402164,1262500,27661.45431637764,dog-run,451,ALM
102,1275000,2550000,2550,132.8615044879832,1275000,27921.317842960358,dog-run,451,ALM
103,1287500,2575000,2575,123.53955456419355,1287500,28182.86408996582,dog-run,451,ALM
104,1300000,2600000,2600,186.52962829873357,1300000,28443.060700416565,dog-run,451,ALM
105,1312500,2625000,2625,165.47175605608345,1312500,28704.702092409134,dog-run,451,ALM
106,1325000,2650000,2650,160.05992661742204,1325000,28965.704535484314,dog-run,451,ALM
107,1337500,2675000,2675,164.66699231231456,1337500,29227.268891096115,dog-run,451,ALM
108,1350000,2700000,2700,181.31355117141788,1350000,29492.527661800385,dog-run,451,ALM
109,1362500,2725000,2725,134.56343187647,1362500,29753.32713651657,dog-run,451,ALM
110,1375000,2750000,2750,174.36233724344865,1375000,30014.54961538315,dog-run,451,ALM
111,1387500,2775000,2775,150.2390200995726,1387500,30276.954573631287,dog-run,451,ALM
112,1400000,2800000,2800,171.3132741838805,1400000,30543.257620811462,dog-run,451,ALM
113,1412500,2825000,2825,161.23959278860656,1412500,30802.33198618889,dog-run,451,ALM
114,1425000,2850000,2850,161.73711544081863,1425000,31062.63584303856,dog-run,451,ALM
115,1437500,2875000,2875,191.41823907979872,1437500,31323.9324157238,dog-run,451,ALM
116,1450000,2900000,2900,174.94881488626118,1450000,31585.44182062149,dog-run,451,ALM
117,1462500,2925000,2925,153.71861339694186,1462500,31848.149938106537,dog-run,451,ALM
118,1475000,2950000,2950,172.96791428297735,1475000,32110.08477663994,dog-run,451,ALM
119,1487500,2975000,2975,172.0164948619497,1487500,32370.794771194458,dog-run,451,ALM
120,1500000,3000000,3000,178.9557761627223,1500000,32633.017872095108,dog-run,451,ALM
121,1512500,3025000,3025,154.50735844726978,1512500,32892.775720119476,dog-run,451,ALM
122,1525000,3050000,3050,160.09982946207998,1525000,33152.59026861191,dog-run,451,ALM
123,1537500,3075000,3075,173.95674808382196,1537500,33412.73681426048,dog-run,451,ALM
124,1550000,3100000,3100,180.42250860671288,1550000,33674.15554904938,dog-run,451,ALM
125,1562500,3125000,3125,173.77207008814736,1562500,33935.41589522362,dog-run,451,ALM
126,1575000,3150000,3150,161.80744201401313,1575000,34196.87759876251,dog-run,451,ALM
127,1587500,3175000,3175,173.26533890095897,1587500,34456.966861248016,dog-run,451,ALM
128,1600000,3200000,3200,163.85904711228326,1600000,34716.60393190384,dog-run,451,ALM
129,1612500,3225000,3225,168.17466381977562,1612500,34978.450370550156,dog-run,451,ALM
130,1625000,3250000,3250,164.85808960012952,1625000,35239.67257189751,dog-run,451,ALM
131,1637500,3275000,3275,180.8867774582376,1637500,35502.21116113663,dog-run,451,ALM
132,1650000,3300000,3300,179.68718376189932,1650000,35765.833604335785,dog-run,451,ALM
133,1662500,3325000,3325,189.44602808818843,1662500,36027.41445040703,dog-run,451,ALM
134,1675000,3350000,3350,166.36418133162925,1675000,36289.101804971695,dog-run,451,ALM
135,1687500,3375000,3375,169.59237561253298,1687500,36550.735515117645,dog-run,451,ALM
136,1700000,3400000,3400,152.3621638285037,1700000,36811.619634628296,dog-run,451,ALM
137,1712500,3425000,3425,176.4161697243963,1712500,37071.72813248634,dog-run,451,ALM
138,1725000,3450000,3450,171.38019769729078,1725000,37332.76130127907,dog-run,451,ALM
139,1737500,3475000,3475,183.2066531858621,1737500,37591.99934005737,dog-run,451,ALM
140,1750000,3500000,3500,162.96799613624484,1750000,37851.28199148178,dog-run,451,ALM
141,1762500,3525000,3525,192.54318321429838,1762500,38110.07045030594,dog-run,451,ALM
142,1775000,3550000,3550,167.2462220937863,1775000,38370.59828400612,dog-run,451,ALM
143,1787500,3575000,3575,194.18411736795147,1787500,38629.76446056366,dog-run,451,ALM
144,1800000,3600000,3600,207.7205503378985,1800000,38887.654656648636,dog-run,451,ALM
145,1812500,3625000,3625,210.84646854517305,1812500,39146.19697761536,dog-run,451,ALM
146,1825000,3650000,3650,209.60388635227332,1825000,39405.30140995979,dog-run,451,ALM
147,1837500,3675000,3675,213.63495153295827,1837500,39666.91727185249,dog-run,451,ALM
148,1850000,3700000,3700,178.35649346136148,1850000,39927.68232297897,dog-run,451,ALM
149,1862500,3725000,3725,157.98415562543786,1862500,40187.79571604729,dog-run,451,ALM
150,1875000,3750000,3750,216.79498408935052,1875000,40449.981979846954,dog-run,451,ALM
151,1887500,3775000,3775,205.57943942314213,1887500,40710.52926802635,dog-run,451,ALM
152,1900000,3800000,3800,231.65462637117798,1900000,40971.240773916245,dog-run,451,ALM
153,1912500,3825000,3825,216.52968199024207,1912500,41230.82574057579,dog-run,451,ALM
154,1925000,3850000,3850,198.46362392058626,1925000,41490.26325464249,dog-run,451,ALM
155,1937500,3875000,3875,195.18540911504627,1937500,41750.751036167145,dog-run,451,ALM
156,1950000,3900000,3900,227.74047267431712,1950000,42010.78653430939,dog-run,451,ALM
157,1962500,3925000,3925,222.1430568860575,1962500,42271.46874451637,dog-run,451,ALM
158,1975000,3950000,3950,215.42224043975952,1975000,42530.5765812397,dog-run,451,ALM
159,1987500,3975000,3975,225.77995104977927,1987500,42789.99950838089,dog-run,451,ALM
160,2000000,4000000,4000,168.45316699422554,2000000,43048.71494793892,dog-run,451,ALM
161,2012500,4025000,4025,220.75072307260976,2012500,43307.95645928383,dog-run,451,ALM
162,2025000,4050000,4050,231.82188365877582,2025000,43567.958220005035,dog-run,451,ALM
163,2037500,4075000,4075,232.1382224625824,2037500,43827.368523836136,dog-run,451,ALM
164,2050000,4100000,4100,223.51612028040805,2050000,44087.26788043976,dog-run,451,ALM
165,2062500,4125000,4125,230.38946541229706,2062500,44347.60700726509,dog-run,451,ALM
166,2075000,4150000,4150,195.2838896244754,2075000,44606.426723241806,dog-run,451,ALM
167,2087500,4175000,4175,228.7582598455655,2087500,44866.995107889175,dog-run,451,ALM
168,2100000,4200000,4200,236.12364686298537,2100000,45125.50807714462,dog-run,451,ALM
169,2112500,4225000,4225,198.41739400619807,2112500,45384.467963695526,dog-run,451,ALM
170,2125000,4250000,4250,230.04479958937515,2125000,45646.051649570465,dog-run,451,ALM
171,2137500,4275000,4275,247.08951813181267,2137500,45906.80287146568,dog-run,451,ALM
172,2150000,4300000,4300,244.33328684592658,2150000,46166.33458471298,dog-run,451,ALM
173,2162500,4325000,4325,237.63393659011254,2162500,46426.016508579254,dog-run,451,ALM
174,2175000,4350000,4350,227.1530994855429,2175000,46685.08461833,dog-run,451,ALM
175,2187500,4375000,4375,217.61023365762975,2187500,46943.24900507927,dog-run,451,ALM
176,2200000,4400000,4400,228.70472781768063,2200000,47212.86344051361,dog-run,451,ALM
177,2212500,4425000,4425,227.14354604323634,2212500,47470.59659028053,dog-run,451,ALM
178,2225000,4450000,4450,216.77756894423368,2225000,47728.948612213135,dog-run,451,ALM
179,2237500,4475000,4475,224.4317746933271,2237500,47987.525337696075,dog-run,451,ALM
180,2250000,4500000,4500,238.2109976835389,2250000,48247.10974788666,dog-run,451,ALM
181,2262500,4525000,4525,215.48075344428966,2262500,48506.167033195496,dog-run,451,ALM
182,2275000,4550000,4550,229.97167265481804,2275000,48766.316130399704,dog-run,451,ALM
183,2287500,4575000,4575,230.00463286646263,2287500,49027.37456250191,dog-run,451,ALM
184,2300000,4600000,4600,222.76662350604465,2300000,49284.1960606575,dog-run,451,ALM
185,2312500,4625000,4625,242.10505559840553,2312500,49542.21755409241,dog-run,451,ALM
186,2325000,4650000,4650,202.97602730836658,2325000,49801.27143955231,dog-run,451,ALM
187,2337500,4675000,4675,224.73850173059753,2337500,50058.90272259712,dog-run,451,ALM
188,2350000,4700000,4700,244.28435812556472,2350000,50317.991681814194,dog-run,451,ALM
189,2362500,4725000,4725,254.32938890332116,2362500,50575.95808553696,dog-run,451,ALM
190,2375000,4750000,4750,258.3239190893433,2375000,50834.98237514496,dog-run,451,ALM
191,2387500,4775000,4775,254.04914579059476,2387500,51093.587792634964,dog-run,451,ALM
192,2400000,4800000,4800,236.6200186698646,2400000,51351.70575475693,dog-run,451,ALM
193,2412500,4825000,4825,223.60478008012987,2412500,51612.21507668495,dog-run,451,ALM
194,2425000,4850000,4850,254.2169598007018,2425000,51871.27027773857,dog-run,451,ALM
195,2437500,4875000,4875,243.68201928472504,2437500,52130.49300932884,dog-run,451,ALM
196,2450000,4900000,4900,252.2804643723527,2450000,52389.59311270714,dog-run,451,ALM
197,2462500,4925000,4925,255.0586452011351,2462500,52648.62766981125,dog-run,451,ALM
198,2475000,4950000,4950,255.05173692015674,2475000,52913.165576934814,dog-run,451,ALM
199,2487500,4975000,4975,240.0108042211795,2487500,53174.11764025688,dog-run,451,ALM
0,0,0,0,6.754408917949161,0,34.94279670715332,dog-run,764,ALM
1,12500,25000,25,9.3095265632446,12500,290.26627564430237,dog-run,764,ALM
2,25000,50000,50,7.359667173674916,25000,578.9289741516113,dog-run,764,ALM
3,37500,75000,75,6.803547994681371,37500,866.9327704906464,dog-run,764,ALM
4,50000,100000,100,6.688996193497736,50000,1156.1440937519073,dog-run,764,ALM
5,62500,125000,125,8.304360120350605,62500,1445.8961350917816,dog-run,764,ALM
6,75000,150000,150,8.799745750329421,75000,1732.6231381893158,dog-run,764,ALM
7,87500,175000,175,6.777922782635942,87500,2021.4238731861115,dog-run,764,ALM
8,100000,200000,200,6.567080490120388,100000,2306.2692363262177,dog-run,764,ALM
9,112500,225000,225,7.079025170461077,112500,2592.928248167038,dog-run,764,ALM
10,125000,250000,250,7.122833643537407,125000,2880.3338148593903,dog-run,764,ALM
11,137500,275000,275,3.9205512911995966,137500,3167.839539051056,dog-run,764,ALM
12,150000,300000,300,6.36697250800046,150000,3456.8297333717346,dog-run,764,ALM
13,162500,325000,325,9.272978977214546,162500,3748.7182989120483,dog-run,764,ALM
14,175000,350000,350,11.409746395994736,175000,4038.2840008735657,dog-run,764,ALM
15,187500,375000,375,10.683265719871027,187500,4318.897497653961,dog-run,764,ALM
16,200000,400000,400,11.057868511818999,200000,4599.714773416519,dog-run,764,ALM
17,212500,425000,425,12.84421605829039,212500,4879.638956785202,dog-run,764,ALM
18,225000,450000,450,4.443006235595696,225000,5155.67093706131,dog-run,764,ALM
19,237500,475000,475,6.839953645523742,237500,5430.2737329006195,dog-run,764,ALM
20,250000,500000,500,13.409337126052893,250000,5702.625843763351,dog-run,764,ALM
21,262500,525000,525,12.699077426505692,262500,5976.058421611786,dog-run,764,ALM
22,275000,550000,550,3.9269766967706574,275000,6253.106415748596,dog-run,764,ALM
23,287500,575000,575,21.040352937140096,287500,6529.396743774414,dog-run,764,ALM
24,300000,600000,600,12.507560336544774,300000,6805.173714399338,dog-run,764,ALM
25,312500,625000,625,14.90933063857407,312500,7078.659052610397,dog-run,764,ALM
26,325000,650000,650,8.133047589310987,325000,7349.035516500473,dog-run,764,ALM
27,337500,675000,675,21.697227940614958,337500,7622.256536483765,dog-run,764,ALM
28,350000,700000,700,24.125876299427325,350000,7900.96385884285,dog-run,764,ALM
29,362500,725000,725,15.244490502144624,362500,8173.271648406982,dog-run,764,ALM
30,375000,750000,750,49.60789893603632,375000,8447.081975460052,dog-run,764,ALM
31,387500,775000,775,17.266387855240687,387500,8721.70681643486,dog-run,764,ALM
32,400000,800000,800,25.546781434853422,400000,8995.558850049973,dog-run,764,ALM
33,412500,825000,825,26.624443838509876,412500,9268.148791790009,dog-run,764,ALM
34,425000,850000,850,29.961124940382877,425000,9541.275592565536,dog-run,764,ALM
35,437500,875000,875,40.26696005727149,437500,9813.197475194931,dog-run,764,ALM
36,450000,900000,900,75.65678808458486,450000,10084.906836509705,dog-run,764,ALM
37,462500,925000,925,55.184420513489684,462500,10356.703327178955,dog-run,764,ALM
38,475000,950000,950,63.55854424103543,475000,10627.329371213913,dog-run,764,ALM
39,487500,975000,975,42.19610182344348,487500,10899.670990228653,dog-run,764,ALM
40,500000,1000000,1000,50.0593864575864,500000,11172.359137058258,dog-run,764,ALM
41,512500,1025000,1025,36.48148469056842,512500,11446.757824897766,dog-run,764,ALM
42,525000,1050000,1050,50.52661955121,525000,11729.5601708889,dog-run,764,ALM
43,537500,1075000,1075,45.54768352029565,537500,12002.566523551941,dog-run,764,ALM
44,550000,1100000,1100,55.6969168526896,550000,12276.734537124634,dog-run,764,ALM
45,562500,1125000,1125,55.31306116678694,562500,12555.03322982788,dog-run,764,ALM
46,575000,1150000,1150,58.40716639667484,575000,12832.148765802383,dog-run,764,ALM
47,587500,1175000,1175,48.75707991331727,587500,13108.534399747849,dog-run,764,ALM
48,600000,1200000,1200,63.971045434536485,600000,13383.871494054794,dog-run,764,ALM
49,612500,1225000,1225,63.637348731364014,612500,13659.031252861023,dog-run,764,ALM
50,625000,1250000,1250,66.87053191978524,625000,13934.387529611588,dog-run,764,ALM
51,637500,1275000,1275,60.42250438543149,637500,14211.482649326324,dog-run,764,ALM
52,650000,1300000,1300,53.68277202667531,650000,14487.836733341217,dog-run,764,ALM
53,662500,1325000,1325,61.17992314531631,662500,14761.953852891922,dog-run,764,ALM
54,675000,1350000,1350,60.70929854014042,675000,15035.171657085419,dog-run,764,ALM
55,687500,1375000,1375,65.86787404879524,687500,15304.18880724907,dog-run,764,ALM
56,700000,1400000,1400,95.84107557859453,700000,15580.422919750214,dog-run,764,ALM
57,712500,1425000,1425,99.04816904542305,712500,15856.16872215271,dog-run,764,ALM
58,725000,1450000,1450,87.26056857555852,725000,16123.35727930069,dog-run,764,ALM
59,737500,1475000,1475,83.13118970122711,737500,16392.35303926468,dog-run,764,ALM
60,750000,1500000,1500,90.01461668739402,750000,16662.304037809372,dog-run,764,ALM
61,762500,1525000,1525,100.78880439867069,762500,16931.274163484573,dog-run,764,ALM
62,775000,1550000,1550,99.69302023803455,775000,17202.455675840378,dog-run,764,ALM
63,787500,1575000,1575,96.77876864791133,787500,17470.80586194992,dog-run,764,ALM
64,800000,1600000,1600,127.63029902227075,800000,17739.61934709549,dog-run,764,ALM
65,812500,1625000,1625,91.25570073289364,812500,18007.169590473175,dog-run,764,ALM
66,825000,1650000,1650,107.93537999135091,825000,18275.37563228607,dog-run,764,ALM
67,837500,1675000,1675,127.38275994421795,837500,18544.248226881027,dog-run,764,ALM
68,850000,1700000,1700,140.4901336704143,850000,18813.08241391182,dog-run,764,ALM
69,862500,1725000,1725,131.72163027199144,862500,19080.21119904518,dog-run,764,ALM
70,875000,1750000,1750,136.53337462520648,875000,19347.56180381775,dog-run,764,ALM
71,887500,1775000,1775,120.85161370380948,887500,19628.31830072403,dog-run,764,ALM
72,900000,1800000,1800,117.27964770710778,900000,19895.334064245224,dog-run,764,ALM
73,912500,1825000,1825,106.31600138224803,912500,20162.978719472885,dog-run,764,ALM
74,925000,1850000,1850,127.47957013848625,925000,20429.02219581604,dog-run,764,ALM
75,937500,1875000,1875,135.3485647786392,937500,20695.65672802925,dog-run,764,ALM
76,950000,1900000,1900,138.73199140226268,950000,20965.61279129982,dog-run,764,ALM
77,962500,1925000,1925,143.41841675790243,962500,21232.829370975494,dog-run,764,ALM
78,975000,1950000,1950,132.65262585936517,975000,21502.917989253998,dog-run,764,ALM
79,987500,1975000,1975,128.75194052496923,987500,21771.548277378082,dog-run,764,ALM
80,1000000,2000000,2000,135.88897325769955,1000000,22041.15671491623,dog-run,764,ALM
81,1012500,2025000,2025,141.72535254965234,1012500,22310.564346790314,dog-run,764,ALM
82,1025000,2050000,2050,125.43347672848063,1025000,22579.794108867645,dog-run,764,ALM
83,1037500,2075000,2075,144.13403280389323,1037500,22846.985226392746,dog-run,764,ALM
84,1050000,2100000,2100,162.7690003706407,1050000,23113.48412656784,dog-run,764,ALM
85,1062500,2125000,2125,162.55893799889427,1062500,23384.00548505783,dog-run,764,ALM
86,1075000,2150000,2150,169.0436279287234,1075000,23654.689393281937,dog-run,764,ALM
87,1087500,2175000,2175,157.87892544874714,1087500,23924.591037511826,dog-run,764,ALM
88,1100000,2200000,2200,147.77253415113643,1100000,24194.334933280945,dog-run,764,ALM
89,1112500,2225000,2225,169.85229224520532,1112500,24463.7024538517,dog-run,764,ALM
90,1125000,2250000,2250,175.03198475021404,1125000,24731.156846046448,dog-run,764,ALM
91,1137500,2275000,2275,154.26604299194352,1137500,25001.956537008286,dog-run,764,ALM
92,1150000,2300000,2300,138.87062914374133,1150000,25270.92151618004,dog-run,764,ALM
93,1162500,2325000,2325,138.8808078044113,1162500,25538.882937669754,dog-run,764,ALM
94,1175000,2350000,2350,150.37283296171844,1175000,25805.2065782547,dog-run,764,ALM
95,1187500,2375000,2375,159.07615103809385,1187500,26073.134270191193,dog-run,764,ALM
96,1200000,2400000,2400,151.66928712963468,1200000,26345.475513458252,dog-run,764,ALM
97,1212500,2425000,2425,155.3043866262745,1212500,26615.529940843582,dog-run,764,ALM
98,1225000,2450000,2450,134.5822146763796,1225000,26884.04099535942,dog-run,764,ALM
99,1237500,2475000,2475,139.19616458926743,1237500,27154.51934480667,dog-run,764,ALM
100,1250000,2500000,2500,150.4915468512898,1250000,27433.733758449554,dog-run,764,ALM
101,1262500,2525000,2525,152.68152662830272,1262500,27700.376058101654,dog-run,764,ALM
102,1275000,2550000,2550,132.32242625851234,1275000,27972.39940881729,dog-run,764,ALM
103,1287500,2575000,2575,147.49644038023985,1287500,28244.18915128708,dog-run,764,ALM
104,1300000,2600000,2600,156.77655710197638,1300000,28513.5990254879,dog-run,764,ALM
105,1312500,2625000,2625,141.01644886579209,1312500,28781.39844417572,dog-run,764,ALM
106,1325000,2650000,2650,168.83637604717632,1325000,29049.078917741776,dog-run,764,ALM
107,1337500,2675000,2675,171.2415771827888,1337500,29318.363614320755,dog-run,764,ALM
108,1350000,2700000,2700,168.66692805131953,1350000,29584.92717552185,dog-run,764,ALM
109,1362500,2725000,2725,154.29073840620092,1362500,29850.67644381523,dog-run,764,ALM
110,1375000,2750000,2750,164.35348410469948,1375000,30117.987895727158,dog-run,764,ALM
111,1387500,2775000,2775,168.42227858805072,1387500,30385.56941986084,dog-run,764,ALM
112,1400000,2800000,2800,162.51153843463953,1400000,30654.367010593414,dog-run,764,ALM
113,1412500,2825000,2825,180.38184027014705,1412500,30922.99141740799,dog-run,764,ALM
114,1425000,2850000,2850,147.19424391197475,1425000,31195.212696790695,dog-run,764,ALM
115,1437500,2875000,2875,158.01626075627385,1437500,31466.594797372818,dog-run,764,ALM
116,1450000,2900000,2900,154.2071399726187,1450000,31732.339606761932,dog-run,764,ALM
117,1462500,2925000,2925,160.70723209498084,1462500,31999.16238451004,dog-run,764,ALM
118,1475000,2950000,2950,163.84766037150928,1475000,32264.892362356186,dog-run,764,ALM
119,1487500,2975000,2975,151.90132706406953,1487500,32532.77398633957,dog-run,764,ALM
120,1500000,3000000,3000,135.28846734737047,1500000,32800.55480051041,dog-run,764,ALM
121,1512500,3025000,3025,173.05794705607758,1512500,33069.59166479111,dog-run,764,ALM
122,1525000,3050000,3050,168.2984742350334,1525000,33336.865693330765,dog-run,764,ALM
123,1537500,3075000,3075,178.84570080478917,1537500,33604.069246053696,dog-run,764,ALM
124,1550000,3100000,3100,168.71581399318663,1550000,33872.80610871315,dog-run,764,ALM
125,1562500,3125000,3125,155.40558433827826,1562500,34140.69909310341,dog-run,764,ALM
126,1575000,3150000,3150,164.06941588086778,1575000,34409.49071645737,dog-run,764,ALM
127,1587500,3175000,3175,176.63031334742192,1587500,34674.70356631279,dog-run,764,ALM
128,1600000,3200000,3200,176.9848158985661,1600000,34943.454493522644,dog-run,764,ALM
129,1612500,3225000,3225,174.5645898263036,1612500,35216.09132552147,dog-run,764,ALM
130,1625000,3250000,3250,176.9901251660744,1625000,35484.44208097458,dog-run,764,ALM
131,1637500,3275000,3275,186.45941291257301,1637500,35753.311879873276,dog-run,764,ALM
132,1650000,3300000,3300,185.51580319666937,1650000,36021.52857708931,dog-run,764,ALM
133,1662500,3325000,3325,176.75958378112804,1662500,36289.342010736465,dog-run,764,ALM
134,1675000,3350000,3350,174.6648241876065,1675000,36558.038907289505,dog-run,764,ALM
135,1687500,3375000,3375,168.0898912589615,1687500,36825.48117399216,dog-run,764,ALM
136,1700000,3400000,3400,159.8571592422839,1700000,37095.16133189201,dog-run,764,ALM
137,1712500,3425000,3425,177.4989558726058,1712500,37364.28597307205,dog-run,764,ALM
138,1725000,3450000,3450,175.35806373351048,1725000,37631.356255054474,dog-run,764,ALM
139,1737500,3475000,3475,190.93974595609825,1737500,37899.1277718544,dog-run,764,ALM
140,1750000,3500000,3500,184.94691692968212,1750000,38178.08929491043,dog-run,764,ALM
141,1762500,3525000,3525,184.50235178790672,1762500,38447.7408182621,dog-run,764,ALM
142,1775000,3550000,3550,165.6163967651464,1775000,38719.48511886597,dog-run,764,ALM
143,1787500,3575000,3575,181.457881406559,1787500,38989.1480948925,dog-run,764,ALM
144,1800000,3600000,3600,186.75883623278332,1800000,39260.223006010056,dog-run,764,ALM
145,1812500,3625000,3625,198.9249832284352,1812500,39528.35897564888,dog-run,764,ALM
146,1825000,3650000,3650,199.72702748872618,1825000,39798.6757414341,dog-run,764,ALM
147,1837500,3675000,3675,189.85407477439477,1837500,40067.45410680771,dog-run,764,ALM
148,1850000,3700000,3700,204.38738190923522,1850000,40337.080396175385,dog-run,764,ALM
149,1862500,3725000,3725,183.29832124308444,1862500,40606.27484178543,dog-run,764,ALM
150,1875000,3750000,3750,201.09234908642458,1875000,40876.00273036957,dog-run,764,ALM
151,1887500,3775000,3775,208.87119847931567,1887500,41151.56354379654,dog-run,764,ALM
152,1900000,3800000,3800,195.14062036448385,1900000,41421.40208911896,dog-run,764,ALM
153,1912500,3825000,3825,194.72907203154895,1912500,41691.519671440125,dog-run,764,ALM
154,1925000,3850000,3850,203.55590422306415,1925000,41958.24807739258,dog-run,764,ALM
155,1937500,3875000,3875,200.95830030135215,1937500,42228.3100168705,dog-run,764,ALM
156,1950000,3900000,3900,198.44635433168324,1950000,42497.62647867203,dog-run,764,ALM
157,1962500,3925000,3925,202.5780983734061,1962500,42765.89426493645,dog-run,764,ALM
158,1975000,3950000,3950,215.60058309966604,1975000,43033.31171441078,dog-run,764,ALM
159,1987500,3975000,3975,205.92815415746523,1987500,43301.885649204254,dog-run,764,ALM
160,2000000,4000000,4000,213.22866998143172,2000000,43567.73425459862,dog-run,764,ALM
161,2012500,4025000,4025,210.76240863694812,2012500,43833.577090740204,dog-run,764,ALM
162,2025000,4050000,4050,194.66035429548975,2025000,44098.11731028557,dog-run,764,ALM
163,2037500,4075000,4075,213.27779558263447,2037500,44362.24137425423,dog-run,764,ALM
164,2050000,4100000,4100,241.13911911797032,2050000,44628.75792336464,dog-run,764,ALM
165,2062500,4125000,4125,228.51809422683647,2062500,44905.923456430435,dog-run,764,ALM
166,2075000,4150000,4150,232.19311636571442,2075000,45172.117089509964,dog-run,764,ALM
167,2087500,4175000,4175,228.83959752265355,2087500,45439.15138602257,dog-run,764,ALM
168,2100000,4200000,4200,229.63170585377412,2100000,45705.266518592834,dog-run,764,ALM
169,2112500,4225000,4225,221.7716786643899,2112500,45969.30802106857,dog-run,764,ALM
170,2125000,4250000,4250,205.30563747947627,2125000,46234.797600746155,dog-run,764,ALM
171,2137500,4275000,4275,238.30846997093295,2137500,46499.186495780945,dog-run,764,ALM
172,2150000,4300000,4300,216.97032340312867,2150000,46764.31810975075,dog-run,764,ALM
173,2162500,4325000,4325,232.43564318184517,2162500,47029.699922800064,dog-run,764,ALM
174,2175000,4350000,4350,235.84035696214127,2175000,47293.07727742195,dog-run,764,ALM
175,2187500,4375000,4375,237.56892904390696,2187500,47558.69503736496,dog-run,764,ALM
176,2200000,4400000,4400,229.2455890884375,2200000,47824.184463977814,dog-run,764,ALM
177,2212500,4425000,4425,251.32266084541084,2212500,48091.024461984634,dog-run,764,ALM
178,2225000,4450000,4450,239.32948394035984,2225000,48358.18190455437,dog-run,764,ALM
179,2237500,4475000,4475,226.81809902881946,2237500,48624.231239795685,dog-run,764,ALM
180,2250000,4500000,4500,246.93805219566985,2250000,48894.81957387924,dog-run,764,ALM
181,2262500,4525000,4525,245.91455965634992,2262500,49159.99523925781,dog-run,764,ALM
182,2275000,4550000,4550,244.92101857767247,2275000,49426.21620297432,dog-run,764,ALM
183,2287500,4575000,4575,251.14036782212943,2287500,49691.21011400223,dog-run,764,ALM
184,2300000,4600000,4600,247.79467051613318,2300000,49957.13676404953,dog-run,764,ALM
185,2312500,4625000,4625,248.11432145894133,2312500,50221.99540066719,dog-run,764,ALM
186,2325000,4650000,4650,262.1775439130962,2325000,50487.3799495697,dog-run,764,ALM
187,2337500,4675000,4675,264.5484556550482,2337500,50754.329223155975,dog-run,764,ALM
188,2350000,4700000,4700,278.05951538536397,2350000,51021.68907046318,dog-run,764,ALM
189,2362500,4725000,4725,271.62781655442853,2362500,51287.64811396599,dog-run,764,ALM
190,2375000,4750000,4750,264.9569464915623,2375000,51553.73375940323,dog-run,764,ALM
191,2387500,4775000,4775,261.1182842395257,2387500,51820.56574988365,dog-run,764,ALM
192,2400000,4800000,4800,260.9691913231858,2400000,52087.7976000309,dog-run,764,ALM
193,2412500,4825000,4825,253.77783106833468,2412500,52352.65075922012,dog-run,764,ALM
194,2425000,4850000,4850,251.4196956125787,2425000,52621.07455039024,dog-run,764,ALM
195,2437500,4875000,4875,265.55934532186336,2437500,52890.90260434151,dog-run,764,ALM
196,2450000,4900000,4900,247.5689966008668,2450000,53157.8724591732,dog-run,764,ALM
197,2462500,4925000,4925,265.18874334226956,2462500,53424.83814787865,dog-run,764,ALM
198,2475000,4950000,4950,260.15093509183464,2475000,53692.29453372955,dog-run,764,ALM
199,2487500,4975000,4975,266.4785957984384,2487500,53959.60692477226,dog-run,764,ALM
0,0,0,0,3.779566935631249,0,36.235228538513184,dog-run,463,ALM
1,12500,25000,25,4.926301291238962,12500,288.2605676651001,dog-run,463,ALM
2,25000,50000,50,11.377045261796438,25000,571.6331713199615,dog-run,463,ALM
3,37500,75000,75,5.2361605167026095,37500,880.1284351348877,dog-run,463,ALM
4,50000,100000,100,5.53324129748397,50000,1201.2648689746857,dog-run,463,ALM
5,62500,125000,125,6.387598614660191,62500,1502.05339884758,dog-run,463,ALM
6,75000,150000,150,6.770772693843277,75000,1787.5645649433136,dog-run,463,ALM
7,87500,175000,175,8.123683427268451,87500,2092.9158847332,dog-run,463,ALM
8,100000,200000,200,15.543093015132396,100000,2378.2901475429535,dog-run,463,ALM
9,112500,225000,225,14.751294592994068,112500,2666.3821144104004,dog-run,463,ALM
10,125000,250000,250,9.559712172960074,125000,2958.8308403491974,dog-run,463,ALM
11,137500,275000,275,9.064426238936,137500,3244.980765104294,dog-run,463,ALM
12,150000,300000,300,5.745317291368174,150000,3521.5664513111115,dog-run,463,ALM
13,162500,325000,325,6.605157425852748,162500,3797.5374789237976,dog-run,463,ALM
14,175000,350000,350,12.892026528794219,175000,4105.252318620682,dog-run,463,ALM
15,187500,375000,375,10.196620517508673,187500,4396.111412525177,dog-run,463,ALM
16,200000,400000,400,8.385055227221862,200000,4667.492265701294,dog-run,463,ALM
17,212500,425000,425,15.656176808479103,212500,4935.160251617432,dog-run,463,ALM
18,225000,450000,450,9.300028182285358,225000,5200.971415519714,dog-run,463,ALM
19,237500,475000,475,10.723062003755226,237500,5467.630618095398,dog-run,463,ALM
20,250000,500000,500,12.528152231372442,250000,5732.483751535416,dog-run,463,ALM
21,262500,525000,525,9.630902956764974,262500,5997.508066177368,dog-run,463,ALM
22,275000,550000,550,8.981158221301897,275000,6262.786873817444,dog-run,463,ALM
23,287500,575000,575,16.46633021392038,287500,6528.448691368103,dog-run,463,ALM
24,300000,600000,600,14.656529377430141,300000,6792.986259222031,dog-run,463,ALM
25,312500,625000,625,12.336279168392778,312500,7065.699410200119,dog-run,463,ALM
26,325000,650000,650,13.95070327489837,325000,7333.594438791275,dog-run,463,ALM
27,337500,675000,675,13.735649832519735,337500,7598.826962709427,dog-run,463,ALM
28,350000,700000,700,15.349914980714871,350000,7870.25577878952,dog-run,463,ALM
29,362500,725000,725,8.809605887599886,362500,8138.367434263229,dog-run,463,ALM
30,375000,750000,750,7.972901211595196,375000,8406.446779251099,dog-run,463,ALM
31,387500,775000,775,28.269541953883902,387500,8672.377705335617,dog-run,463,ALM
32,400000,800000,800,18.622620025653173,400000,8935.211708068848,dog-run,463,ALM
33,412500,825000,825,18.866658178441632,412500,9198.718148231506,dog-run,463,ALM
34,425000,850000,850,24.753128391625722,425000,9462.010755062103,dog-run,463,ALM
35,437500,875000,875,8.011083055223445,437500,9724.8237118721,dog-run,463,ALM
36,450000,900000,900,19.47598032746615,450000,9988.360893249512,dog-run,463,ALM
37,462500,925000,925,10.073706240096195,462500,10256.587037801743,dog-run,463,ALM
38,475000,950000,950,9.198055189678687,475000,10520.421743392944,dog-run,463,ALM
39,487500,975000,975,22.14591362381216,487500,10787.174090385437,dog-run,463,ALM
40,500000,1000000,1000,20.614159196833768,500000,11057.103458404541,dog-run,463,ALM
41,512500,1025000,1025,24.941441753873892,512500,11322.348401784897,dog-run,463,ALM
42,525000,1050000,1050,26.68517766066834,525000,11588.333504676819,dog-run,463,ALM
43,537500,1075000,1075,26.60413525690144,537500,11867.250222206116,dog-run,463,ALM
44,550000,1100000,1100,13.774898555721226,550000,12134.17425274849,dog-run,463,ALM
45,562500,1125000,1125,31.39892614148282,562500,12400.819503545761,dog-run,463,ALM
46,575000,1150000,1150,26.170592371642634,575000,12665.503547668457,dog-run,463,ALM
47,587500,1175000,1175,31.995244433284334,587500,12928.984647035599,dog-run,463,ALM
48,600000,1200000,1200,37.4852291858942,600000,13194.91457080841,dog-run,463,ALM
49,612500,1225000,1225,41.658315479885665,612500,13460.235231876373,dog-run,463,ALM
50,625000,1250000,1250,39.685812435149565,625000,13727.31888628006,dog-run,463,ALM
51,637500,1275000,1275,44.0449250712809,637500,13992.233199119568,dog-run,463,ALM
52,650000,1300000,1300,54.15059302878507,650000,14257.848977088928,dog-run,463,ALM
53,662500,1325000,1325,48.16121328069321,662500,14522.144351005554,dog-run,463,ALM
54,675000,1350000,1350,52.94799863709305,675000,14790.69803762436,dog-run,463,ALM
55,687500,1375000,1375,49.308306319393836,687500,15060.083355426788,dog-run,463,ALM
56,700000,1400000,1400,62.28980666414928,700000,15324.608699560165,dog-run,463,ALM
57,712500,1425000,1425,56.73747567819031,712500,15592.072387456894,dog-run,463,ALM
58,725000,1450000,1450,59.448873543737605,725000,15856.704739809036,dog-run,463,ALM
59,737500,1475000,1475,52.59546003550713,737500,16125.20103430748,dog-run,463,ALM
60,750000,1500000,1500,66.63538302004295,750000,16392.031380414963,dog-run,463,ALM
61,762500,1525000,1525,65.56503225448837,762500,16654.82069325447,dog-run,463,ALM
62,775000,1550000,1550,53.01304527432607,775000,16915.50378370285,dog-run,463,ALM
63,787500,1575000,1575,79.1594116508075,787500,17174.64752984047,dog-run,463,ALM
64,800000,1600000,1600,82.1844996376374,800000,17438.159790039062,dog-run,463,ALM
65,812500,1625000,1625,92.93100105400802,812500,17702.89447784424,dog-run,463,ALM
66,825000,1650000,1650,87.94083461141443,825000,17963.234341859818,dog-run,463,ALM
67,837500,1675000,1675,80.79775479121085,837500,18222.881171941757,dog-run,463,ALM
68,850000,1700000,1700,80.06702075224531,850000,18481.94511795044,dog-run,463,ALM
69,862500,1725000,1725,76.72839541424177,862500,18746.879319667816,dog-run,463,ALM
70,875000,1750000,1750,100.56763635261102,875000,19005.64458179474,dog-run,463,ALM
71,887500,1775000,1775,116.63463235128381,887500,19266.700922489166,dog-run,463,ALM
72,900000,1800000,1800,99.62438357728306,900000,19529.517151594162,dog-run,463,ALM
73,912500,1825000,1825,124.90250319490585,912500,19789.329731464386,dog-run,463,ALM
74,925000,1850000,1850,107.00115642650742,925000,20048.6708650589,dog-run,463,ALM
75,937500,1875000,1875,102.67515517750743,937500,20309.79517865181,dog-run,463,ALM
76,950000,1900000,1900,118.1384350738804,950000,20570.59039092064,dog-run,463,ALM
77,962500,1925000,1925,135.22341125189374,962500,20829.774119377136,dog-run,463,ALM
78,975000,1950000,1950,112.75018821676072,975000,21089.382933855057,dog-run,463,ALM
79,987500,1975000,1975,99.11225884764967,987500,21349.43934249878,dog-run,463,ALM
80,1000000,2000000,2000,99.74860926890594,1000000,21610.014822244644,dog-run,463,ALM
81,1012500,2025000,2025,110.08479660572716,1012500,21870.664663553238,dog-run,463,ALM
82,1025000,2050000,2050,92.91329517460785,1025000,22132.774350881577,dog-run,463,ALM
83,1037500,2075000,2075,86.86183842733072,1037500,22392.306725502014,dog-run,463,ALM
84,1050000,2100000,2100,90.04627212585663,1050000,22655.51753592491,dog-run,463,ALM
85,1062500,2125000,2125,129.43479819161365,1062500,22915.339709043503,dog-run,463,ALM
86,1075000,2150000,2150,131.43687124527662,1075000,23174.626782655716,dog-run,463,ALM
87,1087500,2175000,2175,129.3462777652088,1087500,23437.413110733032,dog-run,463,ALM
88,1100000,2200000,2200,115.30814848673307,1100000,23696.170961380005,dog-run,463,ALM
89,1112500,2225000,2225,112.88239866137046,1112500,23954.14736056328,dog-run,463,ALM
90,1125000,2250000,2250,148.9863638563674,1125000,24212.062779426575,dog-run,463,ALM
91,1137500,2275000,2275,137.49647582253849,1137500,24470.0902364254,dog-run,463,ALM
92,1150000,2300000,2300,142.93032052650375,1150000,24727.880443811417,dog-run,463,ALM
93,1162500,2325000,2325,134.60662878173568,1162500,24985.607493400574,dog-run,463,ALM
94,1175000,2350000,2350,119.96089478887893,1175000,25242.36799621582,dog-run,463,ALM
95,1187500,2375000,2375,168.46685752278287,1187500,25497.787368297577,dog-run,463,ALM
96,1200000,2400000,2400,143.69512600584952,1200000,25754.2382440567,dog-run,463,ALM
97,1212500,2425000,2425,141.8583206870921,1212500,26010.903135299683,dog-run,463,ALM
98,1225000,2450000,2450,144.2561928797969,1225000,26268.19996523857,dog-run,463,ALM
99,1237500,2475000,2475,125.72217551255967,1237500,26529.032083511353,dog-run,463,ALM
100,1250000,2500000,2500,112.06113946009188,1250000,26786.16563653946,dog-run,463,ALM
101,1262500,2525000,2525,136.85104693073245,1262500,27044.018411397934,dog-run,463,ALM
102,1275000,2550000,2550,170.22265988370904,1275000,27305.137075424194,dog-run,463,ALM
103,1287500,2575000,2575,159.62871299477624,1287500,27564.95294737816,dog-run,463,ALM
104,1300000,2600000,2600,163.12004372427796,1300000,27822.016982793808,dog-run,463,ALM
105,1312500,2625000,2625,158.70903478139314,1312500,28076.608106851578,dog-run,463,ALM
106,1325000,2650000,2650,148.55783005869256,1325000,28332.040919303894,dog-run,463,ALM
107,1337500,2675000,2675,135.66862545084683,1337500,28588.509856700897,dog-run,463,ALM
108,1350000,2700000,2700,176.7269058529016,1350000,28843.76981663704,dog-run,463,ALM
109,1362500,2725000,2725,165.50226453677163,1362500,29100.10126876831,dog-run,463,ALM
110,1375000,2750000,2750,147.2916312695133,1375000,29355.8483543396,dog-run,463,ALM
111,1387500,2775000,2775,172.9358397217482,1387500,29612.265473604202,dog-run,463,ALM
112,1400000,2800000,2800,155.9412522967635,1400000,29867.292081594467,dog-run,463,ALM
113,1412500,2825000,2825,134.5787894154944,1412500,30121.946611166,dog-run,463,ALM
114,1425000,2850000,2850,135.33459769143164,1425000,30383.810573101044,dog-run,463,ALM
115,1437500,2875000,2875,134.43280324933977,1437500,30639.685437202454,dog-run,463,ALM
116,1450000,2900000,2900,148.399396029122,1450000,30896.15326476097,dog-run,463,ALM
117,1462500,2925000,2925,139.29911575579644,1462500,31152.422917842865,dog-run,463,ALM
118,1475000,2950000,2950,153.8466952756824,1475000,31414.203935861588,dog-run,463,ALM
119,1487500,2975000,2975,165.74245395655123,1487500,31670.619037866592,dog-run,463,ALM
120,1500000,3000000,3000,172.9757242871617,1500000,31925.217564105988,dog-run,463,ALM
121,1512500,3025000,3025,144.54418737418877,1512500,32178.979428768158,dog-run,463,ALM
122,1525000,3050000,3050,162.2844217013541,1525000,32432.756119966507,dog-run,463,ALM
123,1537500,3075000,3075,167.49493944490757,1537500,32686.64359140396,dog-run,463,ALM
124,1550000,3100000,3100,173.09059559551207,1550000,32942.216089725494,dog-run,463,ALM
125,1562500,3125000,3125,178.9752675526328,1562500,33196.61572980881,dog-run,463,ALM
126,1575000,3150000,3150,163.79689655922692,1575000,33452.512749671936,dog-run,463,ALM
127,1587500,3175000,3175,151.39664256368448,1587500,33709.23676133156,dog-run,463,ALM
128,1600000,3200000,3200,156.5881951207387,1600000,33964.634420871735,dog-run,463,ALM
129,1612500,3225000,3225,168.15069503436447,1612500,34224.23098540306,dog-run,463,ALM
130,1625000,3250000,3250,169.7860242765243,1625000,34479.08941578865,dog-run,463,ALM
131,1637500,3275000,3275,158.28312868530503,1637500,34734.382786512375,dog-run,463,ALM
132,1650000,3300000,3300,171.20299617459418,1650000,34991.18263959885,dog-run,463,ALM
133,1662500,3325000,3325,176.63860864785374,1662500,35253.274340867996,dog-run,463,ALM
134,1675000,3350000,3350,168.92453925851515,1675000,35509.87084341049,dog-run,463,ALM
135,1687500,3375000,3375,164.3374347149006,1687500,35766.0716676712,dog-run,463,ALM
136,1700000,3400000,3400,154.5001266814229,1700000,36022.681465387344,dog-run,463,ALM
137,1712500,3425000,3425,161.05441281315126,1712500,36279.53677821159,dog-run,463,ALM
138,1725000,3450000,3450,165.83478225721652,1725000,36535.60425519943,dog-run,463,ALM
139,1737500,3475000,3475,174.52715903262498,1737500,36790.07567048073,dog-run,463,ALM
140,1750000,3500000,3500,181.112081214324,1750000,37045.17268419266,dog-run,463,ALM
141,1762500,3525000,3525,182.08729819569865,1762500,37301.51715493202,dog-run,463,ALM
142,1775000,3550000,3550,188.77409470883225,1775000,37557.494456768036,dog-run,463,ALM
143,1787500,3575000,3575,178.82765139747755,1787500,37812.515429496765,dog-run,463,ALM
144,1800000,3600000,3600,155.50472674258407,1800000,38065.98363161087,dog-run,463,ALM
145,1812500,3625000,3625,183.81556947825874,1812500,38326.07242512703,dog-run,463,ALM
146,1825000,3650000,3650,186.66697856653818,1825000,38580.69509148598,dog-run,463,ALM
147,1837500,3675000,3675,179.40824973247572,1837500,38835.49938583374,dog-run,463,ALM
148,1850000,3700000,3700,181.41204057284267,1850000,39095.08648085594,dog-run,463,ALM
149,1862500,3725000,3725,188.43212051398618,1862500,39349.391714811325,dog-run,463,ALM
150,1875000,3750000,3750,182.49376330631281,1875000,39604.06013774872,dog-run,463,ALM
151,1887500,3775000,3775,198.04503337472394,1887500,39858.00376844406,dog-run,463,ALM
152,1900000,3800000,3800,166.43256045345555,1900000,40111.684366226196,dog-run,463,ALM
153,1912500,3825000,3825,193.98785289885677,1912500,40365.79172587395,dog-run,463,ALM
154,1925000,3850000,3850,176.5194122476468,1925000,40619.74604535103,dog-run,463,ALM
155,1937500,3875000,3875,201.64837002705755,1937500,40872.38779807091,dog-run,463,ALM
156,1950000,3900000,3900,198.51252103604378,1950000,41125.89453840256,dog-run,463,ALM
157,1962500,3925000,3925,190.18999825617442,1962500,41379.40721487999,dog-run,463,ALM
158,1975000,3950000,3950,194.50397922226063,1975000,41633.742488622665,dog-run,463,ALM
159,1987500,3975000,3975,217.042453701964,1987500,41887.5736079216,dog-run,463,ALM
160,2000000,4000000,4000,210.510602543382,2000000,42142.81949424744,dog-run,463,ALM
161,2012500,4025000,4025,194.4420667983643,2012500,42397.3919198513,dog-run,463,ALM
162,2025000,4050000,4050,223.175632236709,2025000,42652.87184023857,dog-run,463,ALM
163,2037500,4075000,4075,211.10118192779754,2037500,42910.635590553284,dog-run,463,ALM
164,2050000,4100000,4100,210.09342718393455,2050000,43172.84818792343,dog-run,463,ALM
165,2062500,4125000,4125,218.72378214183442,2062500,43427.65901637077,dog-run,463,ALM
166,2075000,4150000,4150,215.59979226449036,2075000,43683.37663936615,dog-run,463,ALM
167,2087500,4175000,4175,216.69238860680426,2087500,43937.923077344894,dog-run,463,ALM
168,2100000,4200000,4200,214.94131873947464,2100000,44191.97031235695,dog-run,463,ALM
169,2112500,4225000,4225,215.2456810588797,2112500,44446.048266887665,dog-run,463,ALM
170,2125000,4250000,4250,204.13857194471748,2125000,44700.65676689148,dog-run,463,ALM
171,2137500,4275000,4275,217.48005511298862,2137500,44956.880838394165,dog-run,463,ALM
172,2150000,4300000,4300,202.43766419281243,2150000,45215.89411115646,dog-run,463,ALM
173,2162500,4325000,4325,227.34890614565558,2162500,45489.808342695236,dog-run,463,ALM
174,2175000,4350000,4350,228.63703876442304,2175000,45750.09192728996,dog-run,463,ALM
175,2187500,4375000,4375,207.6670340509533,2187500,46009.55957365036,dog-run,463,ALM
176,2200000,4400000,4400,192.22012143139176,2200000,46264.57131743431,dog-run,463,ALM
177,2212500,4425000,4425,209.9924229695136,2212500,46519.97537136078,dog-run,463,ALM
178,2225000,4450000,4450,232.60131083089792,2225000,46780.1277987957,dog-run,463,ALM
179,2237500,4475000,4475,242.8203621626535,2237500,47040.11929035187,dog-run,463,ALM
180,2250000,4500000,4500,228.16945515519177,2250000,47296.25680613518,dog-run,463,ALM
181,2262500,4525000,4525,233.32210211986995,2262500,47551.12646985054,dog-run,463,ALM
182,2275000,4550000,4550,240.30111730705886,2275000,47806.375546216965,dog-run,463,ALM
183,2287500,4575000,4575,248.11553180084798,2287500,48059.61411547661,dog-run,463,ALM
184,2300000,4600000,4600,259.6812464691569,2300000,48317.189331293106,dog-run,463,ALM
185,2312500,4625000,4625,245.56888541465082,2312500,48573.402816295624,dog-run,463,ALM
186,2325000,4650000,4650,254.44065530547454,2325000,48828.594984292984,dog-run,463,ALM
187,2337500,4675000,4675,256.9190175837299,2337500,49085.016767024994,dog-run,463,ALM
188,2350000,4700000,4700,232.56575041815714,2350000,49341.95448970795,dog-run,463,ALM
189,2362500,4725000,4725,246.87205090043898,2362500,49605.159303188324,dog-run,463,ALM
190,2375000,4750000,4750,237.0593183544867,2375000,49864.962621450424,dog-run,463,ALM
191,2387500,4775000,4775,251.89277315570985,2387500,50118.23144817352,dog-run,463,ALM
192,2400000,4800000,4800,237.14400608341367,2400000,50377.03781580925,dog-run,463,ALM
193,2412500,4825000,4825,246.90457918465336,2412500,50631.51093840599,dog-run,463,ALM
194,2425000,4850000,4850,249.4178040255405,2425000,50892.823214530945,dog-run,463,ALM
195,2437500,4875000,4875,255.18528415782484,2437500,51149.94113945961,dog-run,463,ALM
196,2450000,4900000,4900,265.7585347923546,2450000,51405.95695900917,dog-run,463,ALM
197,2462500,4925000,4925,277.68601517960013,2462500,51662.87714886665,dog-run,463,ALM
198,2475000,4950000,4950,245.9712704646072,2475000,51919.955743551254,dog-run,463,ALM
199,2487500,4975000,4975,243.93913110598538,2487500,52177.60664153099,dog-run,463,ALM
0,0,0,0,6.008821011097719,0,33.53160738945007,dog-run,896,ALM
1,12500,25000,25,12.896389649284666,12500,271.52239084243774,dog-run,896,ALM
2,25000,50000,50,15.358964287973413,25000,547.4539601802826,dog-run,896,ALM
3,37500,75000,75,9.902649528510242,37500,821.9880301952362,dog-run,896,ALM
4,50000,100000,100,17.615168906848346,50000,1098.025471687317,dog-run,896,ALM
5,62500,125000,125,16.138617907456975,62500,1372.5495166778564,dog-run,896,ALM
6,75000,150000,150,7.093963238264121,75000,1647.900839805603,dog-run,896,ALM
7,87500,175000,175,10.455848579567618,87500,1921.3977990150452,dog-run,896,ALM
8,100000,200000,200,6.767090605260101,100000,2193.8484041690826,dog-run,896,ALM
9,112500,225000,225,10.767909567643633,112500,2466.8799414634705,dog-run,896,ALM
10,125000,250000,250,8.668898389575808,125000,2741.985171318054,dog-run,896,ALM
11,137500,275000,275,4.43465474886968,137500,3018.0444219112396,dog-run,896,ALM
12,150000,300000,300,7.300533941390491,150000,3290.7497696876526,dog-run,896,ALM
13,162500,325000,325,7.305738131940549,162500,3561.5592000484467,dog-run,896,ALM
14,175000,350000,350,2.339218629058711,175000,3834.7405376434326,dog-run,896,ALM
15,187500,375000,375,11.182022289379363,187500,4110.509645938873,dog-run,896,ALM
16,200000,400000,400,6.250573486554241,200000,4383.091702222824,dog-run,896,ALM
17,212500,425000,425,8.932590401637464,212500,4652.157108783722,dog-run,896,ALM
18,225000,450000,450,13.2574749603355,225000,4920.926976919174,dog-run,896,ALM
19,237500,475000,475,6.55626503957896,237500,5188.348366498947,dog-run,896,ALM
20,250000,500000,500,7.053601588284868,250000,5456.7892689704895,dog-run,896,ALM
21,262500,525000,525,9.407768081456442,262500,5724.658072471619,dog-run,896,ALM
22,275000,550000,550,13.178829611225975,275000,5992.200996160507,dog-run,896,ALM
23,287500,575000,575,29.728130040436263,287500,6257.38575220108,dog-run,896,ALM
24,300000,600000,600,26.47463762297186,300000,6521.0317261219025,dog-run,896,ALM
25,312500,625000,625,26.413619424558213,312500,6785.125482082367,dog-run,896,ALM
26,325000,650000,650,41.87149167230762,325000,7057.040587425232,dog-run,896,ALM
27,337500,675000,675,56.4419167720558,337500,7321.044214963913,dog-run,896,ALM
28,350000,700000,700,34.65273115122637,350000,7587.385922193527,dog-run,896,ALM
29,362500,725000,725,27.597881346929956,362500,7855.8390853405,dog-run,896,ALM
30,375000,750000,750,41.06459831855512,375000,8120.051320552826,dog-run,896,ALM
31,387500,775000,775,51.06877622867912,387500,8397.308316469193,dog-run,896,ALM
32,400000,800000,800,52.57133792059479,400000,8662.065639257431,dog-run,896,ALM
33,412500,825000,825,67.30840361330202,412500,8927.606528759003,dog-run,896,ALM
34,425000,850000,850,76.69857424522364,425000,9191.947578430176,dog-run,896,ALM
35,437500,875000,875,77.68365299421184,437500,9454.773638010025,dog-run,896,ALM
36,450000,900000,900,45.50518341735756,450000,9717.514658689499,dog-run,896,ALM
37,462500,925000,925,69.75136615290776,462500,9982.161685228348,dog-run,896,ALM
38,475000,950000,950,60.11509836311511,475000,10246.402684688568,dog-run,896,ALM
39,487500,975000,975,67.76495096156205,487500,10510.352961540222,dog-run,896,ALM
40,500000,1000000,1000,64.48409878299316,500000,10772.909309625626,dog-run,896,ALM
41,512500,1025000,1025,65.51617361824758,512500,11038.017802715302,dog-run,896,ALM
42,525000,1050000,1050,65.85127276572788,525000,11299.51886177063,dog-run,896,ALM
43,537500,1075000,1075,67.47439671248658,537500,11559.552526950836,dog-run,896,ALM
44,550000,1100000,1100,79.06185169609925,550000,11821.919420003891,dog-run,896,ALM
45,562500,1125000,1125,98.88788446064682,562500,12086.135739326477,dog-run,896,ALM
46,575000,1150000,1150,84.31908037693658,575000,12346.441287279129,dog-run,896,ALM
47,587500,1175000,1175,109.00730589738939,587500,12611.330471992493,dog-run,896,ALM
48,600000,1200000,1200,99.93365936266207,600000,12869.14618062973,dog-run,896,ALM
49,612500,1225000,1225,112.5373643751811,612500,13128.829268932343,dog-run,896,ALM
50,625000,1250000,1250,127.42385422302758,625000,13387.407990932465,dog-run,896,ALM
51,637500,1275000,1275,136.03102523698306,637500,13645.349610328674,dog-run,896,ALM
52,650000,1300000,1300,120.23276379754456,650000,13903.831743955612,dog-run,896,ALM
53,662500,1325000,1325,144.92573086299285,662500,14161.960147857666,dog-run,896,ALM
54,675000,1350000,1350,137.81107168284842,675000,14420.71051645279,dog-run,896,ALM
55,687500,1375000,1375,127.025303613984,687500,14681.735957145691,dog-run,896,ALM
56,700000,1400000,1400,149.65090731200533,700000,14941.215635061264,dog-run,896,ALM
57,712500,1425000,1425,179.50892154233452,712500,15201.102932691574,dog-run,896,ALM
58,725000,1450000,1450,152.98811564611202,725000,15459.632615804672,dog-run,896,ALM
59,737500,1475000,1475,148.0694170206552,737500,15719.102429389954,dog-run,896,ALM
60,750000,1500000,1500,154.76536004114382,750000,15987.684407711029,dog-run,896,ALM
61,762500,1525000,1525,121.5775602064022,762500,16246.951278448105,dog-run,896,ALM
62,775000,1550000,1550,89.64823163834744,775000,16509.14200949669,dog-run,896,ALM
63,787500,1575000,1575,140.42465697877566,787500,16771.77850174904,dog-run,896,ALM
64,800000,1600000,1600,122.4807787078576,800000,17033.09391450882,dog-run,896,ALM
65,812500,1625000,1625,121.10917948504493,812500,17294.737446784973,dog-run,896,ALM
66,825000,1650000,1650,162.4938056053175,825000,17555.069840669632,dog-run,896,ALM
67,837500,1675000,1675,155.88233124517475,837500,17814.97963500023,dog-run,896,ALM
68,850000,1700000,1700,129.00092607705864,850000,18074.797464370728,dog-run,896,ALM
69,862500,1725000,1725,142.43573701279337,862500,18334.387854099274,dog-run,896,ALM
70,875000,1750000,1750,133.76987847580443,875000,18593.97443151474,dog-run,896,ALM
71,887500,1775000,1775,130.78247784128524,887500,18853.767576932907,dog-run,896,ALM
72,900000,1800000,1800,116.89455934881917,900000,19114.181751012802,dog-run,896,ALM
73,912500,1825000,1825,159.82451045437466,912500,19374.30594944954,dog-run,896,ALM
74,925000,1850000,1850,180.19821762303198,925000,19634.313777923584,dog-run,896,ALM
75,937500,1875000,1875,154.5823010269571,937500,19904.620165109634,dog-run,896,ALM
76,950000,1900000,1900,178.189198610789,950000,20164.171665906906,dog-run,896,ALM
77,962500,1925000,1925,163.69548766587155,962500,20428.55687212944,dog-run,896,ALM
78,975000,1950000,1950,158.63478350542155,975000,20695.141390562057,dog-run,896,ALM
79,987500,1975000,1975,157.68398285629044,987500,20951.823978424072,dog-run,896,ALM
80,1000000,2000000,2000,146.73227765584429,1000000,21209.275613307953,dog-run,896,ALM
81,1012500,2025000,2025,158.3351666644973,1012500,21467.697731733322,dog-run,896,ALM
82,1025000,2050000,2050,168.77490148465614,1025000,21725.414999485016,dog-run,896,ALM
83,1037500,2075000,2075,147.86345150207404,1037500,21982.533186674118,dog-run,896,ALM
84,1050000,2100000,2100,154.684516227609,1050000,22240.29759311676,dog-run,896,ALM
85,1062500,2125000,2125,144.4599277441975,1062500,22499.539077281952,dog-run,896,ALM
86,1075000,2150000,2150,148.92133233146842,1075000,22761.619347572327,dog-run,896,ALM
87,1087500,2175000,2175,170.26476428223637,1087500,23023.74143218994,dog-run,896,ALM
88,1100000,2200000,2200,170.52495094723957,1100000,23285.846472501755,dog-run,896,ALM
89,1112500,2225000,2225,166.29945155087188,1112500,23547.565623998642,dog-run,896,ALM
90,1125000,2250000,2250,159.4307192144469,1125000,23809.629192829132,dog-run,896,ALM
91,1137500,2275000,2275,170.68883951351503,1137500,24071.102179050446,dog-run,896,ALM
92,1150000,2300000,2300,142.85890957020928,1150000,24330.01411652565,dog-run,896,ALM
93,1162500,2325000,2325,152.11072308317415,1162500,24606.39780497551,dog-run,896,ALM
94,1175000,2350000,2350,164.21252147318776,1175000,24866.05477309227,dog-run,896,ALM
95,1187500,2375000,2375,180.723355526868,1187500,25125.243168115616,dog-run,896,ALM
96,1200000,2400000,2400,172.04841266792045,1200000,25382.93110370636,dog-run,896,ALM
97,1212500,2425000,2425,166.15491487463174,1212500,25640.067524194717,dog-run,896,ALM
98,1225000,2450000,2450,153.7330302452328,1225000,25899.613248109818,dog-run,896,ALM
99,1237500,2475000,2475,172.6862410022656,1237500,26158.41304039955,dog-run,896,ALM
100,1250000,2500000,2500,175.76835947580986,1250000,26418.17937397957,dog-run,896,ALM
101,1262500,2525000,2525,173.714283456636,1262500,26677.08531332016,dog-run,896,ALM
102,1275000,2550000,2550,204.24216206757094,1275000,26934.579380989075,dog-run,896,ALM
103,1287500,2575000,2575,196.98143747778414,1287500,27193.24114394188,dog-run,896,ALM
104,1300000,2600000,2600,200.02203023261126,1300000,27452.478756904602,dog-run,896,ALM
105,1312500,2625000,2625,192.51364327016864,1312500,27712.40076303482,dog-run,896,ALM
106,1325000,2650000,2650,200.45393191369504,1325000,27969.108835220337,dog-run,896,ALM
107,1337500,2675000,2675,203.1927302970965,1337500,28226.455022096634,dog-run,896,ALM
108,1350000,2700000,2700,190.97212115949264,1350000,28497.2433552742,dog-run,896,ALM
109,1362500,2725000,2725,191.90299902468877,1362500,28756.940202236176,dog-run,896,ALM
110,1375000,2750000,2750,175.7423789627352,1375000,29015.814542531967,dog-run,896,ALM
111,1387500,2775000,2775,205.18528352037416,1387500,29277.012018203735,dog-run,896,ALM
112,1400000,2800000,2800,169.98979470556873,1400000,29539.178602457047,dog-run,896,ALM
113,1412500,2825000,2825,179.63413473401798,1412500,29799.56000351906,dog-run,896,ALM
114,1425000,2850000,2850,154.49306089390808,1425000,30057.9185423851,dog-run,896,ALM
115,1437500,2875000,2875,177.44860976341084,1437500,30318.1011698246,dog-run,896,ALM
116,1450000,2900000,2900,167.9693321485984,1450000,30580.653823375702,dog-run,896,ALM
117,1462500,2925000,2925,176.24027013049567,1462500,30842.20231103897,dog-run,896,ALM
118,1475000,2950000,2950,159.611455291398,1475000,31104.173456907272,dog-run,896,ALM
119,1487500,2975000,2975,132.86902612016078,1487500,31366.046396017075,dog-run,896,ALM
120,1500000,3000000,3000,162.91344227084107,1500000,31628.31132864952,dog-run,896,ALM
121,1512500,3025000,3025,154.16167870901316,1512500,31889.642613887787,dog-run,896,ALM
122,1525000,3050000,3050,174.00592892180595,1525000,32151.332368850708,dog-run,896,ALM
123,1537500,3075000,3075,165.20301566860303,1537500,32424.82081580162,dog-run,896,ALM
124,1550000,3100000,3100,143.94421171574356,1550000,32687.27870774269,dog-run,896,ALM
125,1562500,3125000,3125,172.20526149279343,1562500,32949.6386590004,dog-run,896,ALM
126,1575000,3150000,3150,168.0561457446586,1575000,33209.98932528496,dog-run,896,ALM
127,1587500,3175000,3175,198.4500002498077,1587500,33470.605164051056,dog-run,896,ALM
128,1600000,3200000,3200,213.90904414529504,1600000,33730.449622154236,dog-run,896,ALM
129,1612500,3225000,3225,198.22861434525944,1612500,33991.92300605774,dog-run,896,ALM
130,1625000,3250000,3250,175.9990779786821,1625000,34251.781373500824,dog-run,896,ALM
131,1637500,3275000,3275,169.72992433216808,1637500,34511.9580283165,dog-run,896,ALM
132,1650000,3300000,3300,198.4377687335975,1650000,34771.41709399223,dog-run,896,ALM
133,1662500,3325000,3325,187.4944345636481,1662500,35030.055517196655,dog-run,896,ALM
134,1675000,3350000,3350,194.62335058789773,1675000,35289.47989702225,dog-run,896,ALM
135,1687500,3375000,3375,195.1211456074312,1687500,35548.16948413849,dog-run,896,ALM
136,1700000,3400000,3400,197.9932645577715,1700000,35807.39630150795,dog-run,896,ALM
137,1712500,3425000,3425,187.41398610487857,1712500,36066.62253904343,dog-run,896,ALM
138,1725000,3450000,3450,124.67863289803691,1725000,36342.50863528252,dog-run,896,ALM
139,1737500,3475000,3475,206.61499486972616,1737500,36604.51825094223,dog-run,896,ALM
140,1750000,3500000,3500,223.65387274498684,1750000,36864.01686286926,dog-run,896,ALM
141,1762500,3525000,3525,241.50840071419094,1762500,37124.40300488472,dog-run,896,ALM
142,1775000,3550000,3550,220.6012835060394,1775000,37384.7038192749,dog-run,896,ALM
143,1787500,3575000,3575,218.624329851413,1787500,37645.21230220795,dog-run,896,ALM
144,1800000,3600000,3600,224.94396735316332,1800000,37904.67762994766,dog-run,896,ALM
145,1812500,3625000,3625,207.19506022681344,1812500,38163.30666446686,dog-run,896,ALM
146,1825000,3650000,3650,214.3926753034205,1825000,38422.19298505783,dog-run,896,ALM
147,1837500,3675000,3675,227.2273853615105,1837500,38683.127581596375,dog-run,896,ALM
148,1850000,3700000,3700,258.1934343801664,1850000,38941.65210056305,dog-run,896,ALM
149,1862500,3725000,3725,236.99171883805283,1862500,39200.30399847031,dog-run,896,ALM
150,1875000,3750000,3750,228.8320653055734,1875000,39459.6030933857,dog-run,896,ALM
151,1887500,3775000,3775,251.10041512178373,1887500,39718.05651760101,dog-run,896,ALM
152,1900000,3800000,3800,236.7533706323083,1900000,39976.71372938156,dog-run,896,ALM
153,1912500,3825000,3825,230.0469974499875,1912500,40248.09600234032,dog-run,896,ALM
154,1925000,3850000,3850,219.86807259772354,1925000,40503.54120230675,dog-run,896,ALM
155,1937500,3875000,3875,248.32514762149617,1937500,40760.59865808487,dog-run,896,ALM
156,1950000,3900000,3900,246.65686478868457,1950000,41019.12624669075,dog-run,896,ALM
157,1962500,3925000,3925,262.05304182370935,1962500,41276.13273334503,dog-run,896,ALM
158,1975000,3950000,3950,249.37044754112466,1975000,41534.681214571,dog-run,896,ALM
159,1987500,3975000,3975,278.28459953900074,1987500,41794.11306834221,dog-run,896,ALM
160,2000000,4000000,4000,269.00490227308677,2000000,42054.21404123306,dog-run,896,ALM
161,2012500,4025000,4025,255.5594684964958,2012500,42313.52199053764,dog-run,896,ALM
162,2025000,4050000,4050,210.07777823605497,2025000,42572.17898440361,dog-run,896,ALM
163,2037500,4075000,4075,261.28029494242753,2037500,42831.23106908798,dog-run,896,ALM
164,2050000,4100000,4100,272.0803730503061,2050000,43090.85473895073,dog-run,896,ALM
165,2062500,4125000,4125,257.4796509985714,2062500,43350.17268323898,dog-run,896,ALM
166,2075000,4150000,4150,294.73350479874136,2075000,43608.94057226181,dog-run,896,ALM
167,2087500,4175000,4175,303.60617410749194,2087500,43867.19733047485,dog-run,896,ALM
168,2100000,4200000,4200,290.74275633527776,2100000,44131.81745004654,dog-run,896,ALM
169,2112500,4225000,4225,285.0787996132569,2112500,44390.752897024155,dog-run,896,ALM
170,2125000,4250000,4250,274.50013635300365,2125000,44650.34484124184,dog-run,896,ALM
171,2137500,4275000,4275,277.6557057929723,2137500,44911.37979221344,dog-run,896,ALM
172,2150000,4300000,4300,273.566586126402,2150000,45172.218479156494,dog-run,896,ALM
173,2162500,4325000,4325,240.93499064503817,2162500,45432.55048418045,dog-run,896,ALM
174,2175000,4350000,4350,274.55079606907526,2175000,45692.652104854584,dog-run,896,ALM
175,2187500,4375000,4375,282.0147976840309,2187500,45952.39989233017,dog-run,896,ALM
176,2200000,4400000,4400,290.3610462001667,2200000,46212.056070804596,dog-run,896,ALM
177,2212500,4425000,4425,288.4360819514989,2212500,46470.443809986115,dog-run,896,ALM
178,2225000,4450000,4450,301.9132284940798,2225000,46727.293982982635,dog-run,896,ALM
179,2237500,4475000,4475,305.23604354352466,2237500,46986.345031023026,dog-run,896,ALM
180,2250000,4500000,4500,311.4069304260405,2250000,47244.894770383835,dog-run,896,ALM
181,2262500,4525000,4525,282.82323567507535,2262500,47503.3580892086,dog-run,896,ALM
182,2275000,4550000,4550,280.1695941859827,2275000,47761.45061278343,dog-run,896,ALM
183,2287500,4575000,4575,285.1101998221605,2287500,48028.04683089256,dog-run,896,ALM
184,2300000,4600000,4600,309.13896607324637,2300000,48288.89251089096,dog-run,896,ALM
185,2312500,4625000,4625,292.6325712173412,2312500,48548.947319984436,dog-run,896,ALM
186,2325000,4650000,4650,272.5609575035487,2325000,48806.13557934761,dog-run,896,ALM
187,2337500,4675000,4675,240.50742554920504,2337500,49065.52686166763,dog-run,896,ALM
188,2350000,4700000,4700,281.1912118506755,2350000,49324.879705905914,dog-run,896,ALM
189,2362500,4725000,4725,308.67231998785326,2362500,49582.973803043365,dog-run,896,ALM
190,2375000,4750000,4750,311.00506753700336,2375000,49841.82398176193,dog-run,896,ALM
191,2387500,4775000,4775,293.5306099099695,2387500,50098.65160655975,dog-run,896,ALM
192,2400000,4800000,4800,288.55527674599733,2400000,50358.004643678665,dog-run,896,ALM
193,2412500,4825000,4825,290.91649291626385,2412500,50616.64423441887,dog-run,896,ALM
194,2425000,4850000,4850,244.8689205330445,2425000,50874.603905916214,dog-run,896,ALM
195,2437500,4875000,4875,269.30559587350933,2437500,51133.40560531616,dog-run,896,ALM
196,2450000,4900000,4900,262.0931582282743,2450000,51392.11620378494,dog-run,896,ALM
197,2462500,4925000,4925,147.93398616580157,2462500,51652.76056575775,dog-run,896,ALM
198,2475000,4950000,4950,311.506397312348,2475000,51921.77519965172,dog-run,896,ALM
199,2487500,4975000,4975,296.88133942877937,2487500,52179.86891293526,dog-run,896,ALM
0,0,0,0,4.562669889675639,0,35.899187088012695,dog-run,657,ALM
1,12500,25000,25,13.595234243936734,12500,321.2372832298279,dog-run,657,ALM
2,25000,50000,50,15.595508561444356,25000,639.7844915390015,dog-run,657,ALM
3,37500,75000,75,9.00404301635607,37500,921.7091345787048,dog-run,657,ALM
4,50000,100000,100,23.28614482084407,50000,1204.2287151813507,dog-run,657,ALM
5,62500,125000,125,18.00469585827916,62500,1492.7323820590973,dog-run,657,ALM
6,75000,150000,150,12.268790466329115,75000,1808.167219877243,dog-run,657,ALM
7,87500,175000,175,13.74229076303232,87500,2095.717359304428,dog-run,657,ALM
8,100000,200000,200,10.935152946083809,100000,2404.433103084564,dog-run,657,ALM
9,112500,225000,225,3.605652354118863,112500,2718.085401535034,dog-run,657,ALM
10,125000,250000,250,8.229372151784961,125000,3015.413425207138,dog-run,657,ALM
11,137500,275000,275,10.967632320690644,137500,3313.737823009491,dog-run,657,ALM
12,150000,300000,300,23.74878195200652,150000,3609.7266895771027,dog-run,657,ALM
13,162500,325000,325,23.813735565972866,162500,3911.969006061554,dog-run,657,ALM
14,175000,350000,350,13.01638555922877,175000,4207.430865049362,dog-run,657,ALM
15,187500,375000,375,27.44348105373,187500,4497.1254823207855,dog-run,657,ALM
16,200000,400000,400,28.384679571709846,200000,4779.867856264114,dog-run,657,ALM
17,212500,425000,425,32.16927741777359,212500,5062.153038740158,dog-run,657,ALM
18,225000,450000,450,11.06404239949137,225000,5341.165920972824,dog-run,657,ALM
19,237500,475000,475,40.91758754935267,237500,5625.66353392601,dog-run,657,ALM
20,250000,500000,500,45.60205433509031,250000,5898.938225746155,dog-run,657,ALM
21,262500,525000,525,44.570849744827605,262500,6173.884784698486,dog-run,657,ALM
22,275000,550000,550,38.90680240848514,275000,6449.640795707703,dog-run,657,ALM
23,287500,575000,575,40.878687695062744,287500,6724.72417640686,dog-run,657,ALM
24,300000,600000,600,35.85691477998982,300000,7008.598514795303,dog-run,657,ALM
25,312500,625000,625,41.32829747131875,312500,7297.129148483276,dog-run,657,ALM
26,325000,650000,650,41.52227934247294,325000,7596.512039899826,dog-run,657,ALM
27,337500,675000,675,20.582118007315245,337500,7871.851167917252,dog-run,657,ALM
28,350000,700000,700,37.9423624844509,350000,8150.989059686661,dog-run,657,ALM
29,362500,725000,725,30.22178070875372,362500,8427.322254180908,dog-run,657,ALM
30,375000,750000,750,38.63579423485096,375000,8702.741334676743,dog-run,657,ALM
31,387500,775000,775,20.724810636036864,387500,8978.99944138527,dog-run,657,ALM
32,400000,800000,800,59.656523997795276,400000,9253.991610765457,dog-run,657,ALM
33,412500,825000,825,59.82482719697056,412500,9529.267873048782,dog-run,657,ALM
34,425000,850000,850,65.75138761575352,425000,9803.473675489426,dog-run,657,ALM
35,437500,875000,875,84.79493715272058,437500,10078.131983757019,dog-run,657,ALM
36,450000,900000,900,70.07803617539454,450000,10350.094702005386,dog-run,657,ALM
37,462500,925000,925,74.01722313497353,462500,10618.827824115753,dog-run,657,ALM
38,475000,950000,950,84.468045985925,475000,10889.325343370438,dog-run,657,ALM
39,487500,975000,975,67.70569698932712,487500,11156.388460159302,dog-run,657,ALM
40,500000,1000000,1000,64.0007016819506,500000,11424.864654541016,dog-run,657,ALM
41,512500,1025000,1025,89.45718949846875,512500,11690.333790302277,dog-run,657,ALM
42,525000,1050000,1050,103.272573259813,525000,11958.729179382324,dog-run,657,ALM
43,537500,1075000,1075,72.6358121519939,537500,12227.171407699585,dog-run,657,ALM
44,550000,1100000,1100,73.24815241695458,550000,12494.04258441925,dog-run,657,ALM
45,562500,1125000,1125,76.56692197129607,562500,12759.6383831501,dog-run,657,ALM
46,575000,1150000,1150,62.18560905615992,575000,13027.880856990814,dog-run,657,ALM
47,587500,1175000,1175,74.12270507455335,587500,13311.573018074036,dog-run,657,ALM
48,600000,1200000,1200,74.5610251626606,600000,13603.491596698761,dog-run,657,ALM
49,612500,1225000,1225,72.65331275422906,612500,13910.568741083145,dog-run,657,ALM
50,625000,1250000,1250,89.25669853451818,625000,14179.17358994484,dog-run,657,ALM
51,637500,1275000,1275,77.27392787139867,637500,14447.406265735626,dog-run,657,ALM
52,650000,1300000,1300,75.8088301494826,650000,14712.780801534653,dog-run,657,ALM
53,662500,1325000,1325,78.73648829892153,662500,14997.497048139572,dog-run,657,ALM
54,675000,1350000,1350,84.24634647133935,675000,15288.64041686058,dog-run,657,ALM
55,687500,1375000,1375,83.29729171265924,687500,15574.395722389221,dog-run,657,ALM
56,700000,1400000,1400,90.10108191803427,700000,15851.914027690887,dog-run,657,ALM
57,712500,1425000,1425,92.93684040358482,712500,16147.90222978592,dog-run,657,ALM
58,725000,1450000,1450,81.75825376881862,725000,16415.75844359398,dog-run,657,ALM
59,737500,1475000,1475,95.08382264232846,737500,16680.401993513107,dog-run,657,ALM
60,750000,1500000,1500,84.04107295917173,750000,16965.252850055695,dog-run,657,ALM
61,762500,1525000,1525,92.740038115678,762500,17245.250809669495,dog-run,657,ALM
62,775000,1550000,1550,90.23864356022116,775000,17520.195398569107,dog-run,657,ALM
63,787500,1575000,1575,95.13939213987972,787500,17796.20231795311,dog-run,657,ALM
64,800000,1600000,1600,88.87130285820409,800000,18083.392871141434,dog-run,657,ALM
65,812500,1625000,1625,107.67219349604798,812500,18354.55464911461,dog-run,657,ALM
66,825000,1650000,1650,113.84518125612276,825000,18626.956622838974,dog-run,657,ALM
67,837500,1675000,1675,98.43247534187171,837500,18900.127380371094,dog-run,657,ALM
68,850000,1700000,1700,114.33839170752381,850000,19172.459409713745,dog-run,657,ALM
69,862500,1725000,1725,99.19573524449731,862500,19452.45368528366,dog-run,657,ALM
70,875000,1750000,1750,93.30476069142152,875000,19736.168313503265,dog-run,657,ALM
71,887500,1775000,1775,129.1130043439121,887500,20009.428937911987,dog-run,657,ALM
72,900000,1800000,1800,111.83485722112403,900000,20283.96952009201,dog-run,657,ALM
73,912500,1825000,1825,116.59068509862416,912500,20560.862599372864,dog-run,657,ALM
74,925000,1850000,1850,130.73914637090996,925000,20840.641141414642,dog-run,657,ALM
75,937500,1875000,1875,116.62847956064896,937500,21112.441547870636,dog-run,657,ALM
76,950000,1900000,1900,92.34477120745859,950000,21382.598048210144,dog-run,657,ALM
77,962500,1925000,1925,125.2925402928965,962500,21644.674741983414,dog-run,657,ALM
78,975000,1950000,1950,131.7124484240199,975000,21909.34000658989,dog-run,657,ALM
79,987500,1975000,1975,124.06357599760415,987500,22189.829126119614,dog-run,657,ALM
80,1000000,2000000,2000,125.67358672739297,1000000,22465.121581077576,dog-run,657,ALM
81,1012500,2025000,2025,102.9836490507053,1012500,22759.86670589447,dog-run,657,ALM
82,1025000,2050000,2050,116.32321648003014,1025000,23045.76560330391,dog-run,657,ALM
83,1037500,2075000,2075,88.38469361258242,1037500,23326.64695739746,dog-run,657,ALM
84,1050000,2100000,2100,143.13144636903135,1050000,23615.80169916153,dog-run,657,ALM
85,1062500,2125000,2125,108.67720732315361,1062500,23914.98862171173,dog-run,657,ALM
86,1075000,2150000,2150,124.92328637931845,1075000,24197.03666806221,dog-run,657,ALM
87,1087500,2175000,2175,143.04770958725584,1087500,24467.058153390884,dog-run,657,ALM
88,1100000,2200000,2200,129.36700186531831,1100000,24740.20329761505,dog-run,657,ALM
89,1112500,2225000,2225,143.26678615636268,1112500,25012.5630671978,dog-run,657,ALM
90,1125000,2250000,2250,132.50706871272382,1125000,25279.18501329422,dog-run,657,ALM
91,1137500,2275000,2275,127.50455278133072,1137500,25549.5986661911,dog-run,657,ALM
92,1150000,2300000,2300,140.05859107221022,1150000,25822.76211667061,dog-run,657,ALM
93,1162500,2325000,2325,171.12725473285963,1162500,26090.19713139534,dog-run,657,ALM
94,1175000,2350000,2350,166.33032831271132,1175000,26357.0016849041,dog-run,657,ALM
95,1187500,2375000,2375,171.9162894841271,1187500,26626.762226819992,dog-run,657,ALM
96,1200000,2400000,2400,169.50133756234337,1200000,26892.11412549019,dog-run,657,ALM
97,1212500,2425000,2425,173.5456571690352,1212500,27159.947858572006,dog-run,657,ALM
98,1225000,2450000,2450,146.48280708586648,1225000,27431.06940627098,dog-run,657,ALM
99,1237500,2475000,2475,186.05179897298913,1237500,27699.959843873978,dog-run,657,ALM
100,1250000,2500000,2500,139.80188418451692,1250000,27968.70240497589,dog-run,657,ALM
101,1262500,2525000,2525,173.9808154426283,1262500,28242.496487617493,dog-run,657,ALM
102,1275000,2550000,2550,168.43349803442462,1275000,28510.740721464157,dog-run,657,ALM
103,1287500,2575000,2575,173.87260841328413,1287500,28775.32519841194,dog-run,657,ALM
104,1300000,2600000,2600,153.8428851418849,1300000,29043.972690820694,dog-run,657,ALM
105,1312500,2625000,2625,172.77222107041035,1312500,29311.44087123871,dog-run,657,ALM
106,1325000,2650000,2650,156.51778265319953,1325000,29581.08554840088,dog-run,657,ALM
107,1337500,2675000,2675,190.9091781054255,1337500,29849.017481565475,dog-run,657,ALM
108,1350000,2700000,2700,143.2245103010501,1350000,30117.994227409363,dog-run,657,ALM
109,1362500,2725000,2725,141.47251906145635,1362500,30386.301601171494,dog-run,657,ALM
110,1375000,2750000,2750,174.66621209648542,1375000,30653.367339372635,dog-run,657,ALM
111,1387500,2775000,2775,166.434910700884,1387500,30922.86405801773,dog-run,657,ALM
112,1400000,2800000,2800,186.04474391065943,1400000,31190.982550621033,dog-run,657,ALM
113,1412500,2825000,2825,187.25945688761448,1412500,31459.508746623993,dog-run,657,ALM
114,1425000,2850000,2850,208.11716093010858,1425000,31727.7414662838,dog-run,657,ALM
115,1437500,2875000,2875,210.65159432209845,1437500,32004.297477960587,dog-run,657,ALM
116,1450000,2900000,2900,213.0230997236578,1450000,32270.310326099396,dog-run,657,ALM
117,1462500,2925000,2925,218.76927445508517,1462500,32534.06899166107,dog-run,657,ALM
118,1475000,2950000,2950,212.16400874753532,1475000,32801.00234079361,dog-run,657,ALM
119,1487500,2975000,2975,196.76868415907148,1487500,33066.74443030357,dog-run,657,ALM
120,1500000,3000000,3000,207.79265066900976,1500000,33336.2052834034,dog-run,657,ALM
121,1512500,3025000,3025,208.60376242669926,1512500,33603.52786207199,dog-run,657,ALM
122,1525000,3050000,3050,195.5818991497713,1525000,33872.365634679794,dog-run,657,ALM
123,1537500,3075000,3075,212.66505714304148,1537500,34135.17966008186,dog-run,657,ALM
124,1550000,3100000,3100,212.13825402047019,1550000,34400.74911260605,dog-run,657,ALM
125,1562500,3125000,3125,200.50356193152925,1562500,34677.39738845825,dog-run,657,ALM
126,1575000,3150000,3150,197.8881991039761,1575000,34944.1353096962,dog-run,657,ALM
127,1587500,3175000,3175,208.50638710033598,1587500,35209.3634929657,dog-run,657,ALM
128,1600000,3200000,3200,208.99398197152482,1600000,35478.587923288345,dog-run,657,ALM
129,1612500,3225000,3225,199.19260877359426,1612500,35746.03872704506,dog-run,657,ALM
130,1625000,3250000,3250,198.40660260442195,1625000,36011.7197868824,dog-run,657,ALM
131,1637500,3275000,3275,204.2034239834984,1637500,36276.315252780914,dog-run,657,ALM
132,1650000,3300000,3300,210.16828082109836,1650000,36543.943598032,dog-run,657,ALM
133,1662500,3325000,3325,203.36359199287622,1662500,36810.38285732269,dog-run,657,ALM
134,1675000,3350000,3350,204.0494052953875,1675000,37078.31892299652,dog-run,657,ALM
135,1687500,3375000,3375,208.05523689137735,1687500,37346.07006692886,dog-run,657,ALM
136,1700000,3400000,3400,189.8023516380469,1700000,37613.39052963257,dog-run,657,ALM
137,1712500,3425000,3425,209.38413858339058,1712500,37891.50299477577,dog-run,657,ALM
138,1725000,3450000,3450,198.94821494831154,1725000,38160.87907290459,dog-run,657,ALM
139,1737500,3475000,3475,215.18088891826537,1737500,38428.5531232357,dog-run,657,ALM
140,1750000,3500000,3500,207.25162488235796,1750000,38696.22327208519,dog-run,657,ALM
141,1762500,3525000,3525,192.35540374693815,1762500,38961.7414252758,dog-run,657,ALM
142,1775000,3550000,3550,213.35254957972975,1775000,39228.90098261833,dog-run,657,ALM
143,1787500,3575000,3575,209.8866389519148,1787500,39495.47224020958,dog-run,657,ALM
144,1800000,3600000,3600,220.20343792780346,1800000,39762.66230201721,dog-run,657,ALM
145,1812500,3625000,3625,231.46877585581151,1812500,40031.73660802841,dog-run,657,ALM
146,1825000,3650000,3650,231.53211858952827,1825000,40301.14919137955,dog-run,657,ALM
147,1837500,3675000,3675,214.7856739340932,1837500,40569.35603475571,dog-run,657,ALM
148,1850000,3700000,3700,212.05211268429358,1850000,40839.07353377342,dog-run,657,ALM
149,1862500,3725000,3725,219.3320411621835,1862500,41105.84763789177,dog-run,657,ALM
150,1875000,3750000,3750,220.76770881182907,1875000,41373.095266103745,dog-run,657,ALM
151,1887500,3775000,3775,217.3397764325783,1887500,41644.07966589928,dog-run,657,ALM
152,1900000,3800000,3800,212.4131214480106,1900000,41912.942715883255,dog-run,657,ALM
153,1912500,3825000,3825,213.64699008398983,1912500,42181.5395822525,dog-run,657,ALM
154,1925000,3850000,3850,238.4839019313878,1925000,42452.13351345062,dog-run,657,ALM
155,1937500,3875000,3875,220.68412550907334,1937500,42720.1641459465,dog-run,657,ALM
156,1950000,3900000,3900,238.06000998513187,1950000,42988.89297890663,dog-run,657,ALM
157,1962500,3925000,3925,240.29353058152182,1962500,43254.742107629776,dog-run,657,ALM
158,1975000,3950000,3950,218.70674525098553,1975000,43523.66620564461,dog-run,657,ALM
159,1987500,3975000,3975,241.48329837217747,1987500,43792.31315732002,dog-run,657,ALM
160,2000000,4000000,4000,242.64137157736255,2000000,44060.70669913292,dog-run,657,ALM
161,2012500,4025000,4025,248.2686876815052,2012500,44327.73457360268,dog-run,657,ALM
162,2025000,4050000,4050,235.91041799511504,2025000,44596.30055761337,dog-run,657,ALM
163,2037500,4075000,4075,246.45867017890714,2037500,44864.44357061386,dog-run,657,ALM
164,2050000,4100000,4100,223.47502603205294,2050000,45132.467319726944,dog-run,657,ALM
165,2062500,4125000,4125,237.3096374467331,2062500,45400.94261956215,dog-run,657,ALM
166,2075000,4150000,4150,235.2462414090778,2075000,45679.59204053879,dog-run,657,ALM
167,2087500,4175000,4175,238.54489539603327,2087500,45948.64963889122,dog-run,657,ALM
168,2100000,4200000,4200,238.83205091066375,2100000,46218.45518565178,dog-run,657,ALM
169,2112500,4225000,4225,245.97425891138832,2112500,46486.739319086075,dog-run,657,ALM
170,2125000,4250000,4250,243.3480625115456,2125000,46754.213448524475,dog-run,657,ALM
171,2137500,4275000,4275,231.37116199568328,2137500,47020.559898138046,dog-run,657,ALM
172,2150000,4300000,4300,229.88376741482222,2150000,47288.2105884552,dog-run,657,ALM
173,2162500,4325000,4325,237.47514953021056,2162500,47556.05665040016,dog-run,657,ALM
174,2175000,4350000,4350,246.404146362318,2175000,47824.26085424423,dog-run,657,ALM
175,2187500,4375000,4375,236.30767763209542,2187500,48091.887911081314,dog-run,657,ALM
176,2200000,4400000,4400,249.86664051143174,2200000,48360.54401803017,dog-run,657,ALM
177,2212500,4425000,4425,238.5439386062461,2212500,48628.69686126709,dog-run,657,ALM
178,2225000,4450000,4450,246.24730385795095,2225000,48895.027191877365,dog-run,657,ALM
179,2237500,4475000,4475,239.5034621269856,2237500,49164.38636016846,dog-run,657,ALM
180,2250000,4500000,4500,247.02082489152963,2250000,49437.99318647385,dog-run,657,ALM
181,2262500,4525000,4525,244.57651998044736,2262500,49707.448951005936,dog-run,657,ALM
182,2275000,4550000,4550,259.72380223828026,2275000,49973.54016017914,dog-run,657,ALM
183,2287500,4575000,4575,255.2417502257374,2287500,50242.06655859947,dog-run,657,ALM
184,2300000,4600000,4600,268.8740058859465,2300000,50507.836928367615,dog-run,657,ALM
185,2312500,4625000,4625,250.54540222941824,2312500,50774.055346250534,dog-run,657,ALM
186,2325000,4650000,4650,256.20162245030235,2325000,51039.17104101181,dog-run,657,ALM
187,2337500,4675000,4675,246.93769670566,2337500,51306.65058231354,dog-run,657,ALM
188,2350000,4700000,4700,256.79088450185515,2350000,51574.82614469528,dog-run,657,ALM
189,2362500,4725000,4725,244.6894972399974,2362500,51841.75633406639,dog-run,657,ALM
190,2375000,4750000,4750,243.1159469474017,2375000,52110.88291835785,dog-run,657,ALM
191,2387500,4775000,4775,264.6758887261598,2387500,52377.45733213425,dog-run,657,ALM
192,2400000,4800000,4800,261.3547230526285,2400000,52643.795926332474,dog-run,657,ALM
193,2412500,4825000,4825,239.16250723397056,2412500,52911.50975871086,dog-run,657,ALM
194,2425000,4850000,4850,258.1483351540639,2425000,53177.24226140976,dog-run,657,ALM
195,2437500,4875000,4875,248.54288712491706,2437500,53454.4429974556,dog-run,657,ALM
196,2450000,4900000,4900,266.23958093761155,2450000,53722.33211660385,dog-run,657,ALM
197,2462500,4925000,4925,213.81328376596485,2462500,53990.911659002304,dog-run,657,ALM
198,2475000,4950000,4950,233.73060270799792,2475000,54258.082620859146,dog-run,657,ALM
199,2487500,4975000,4975,256.29670384308605,2487500,54526.9781730175,dog-run,657,ALM
0,0,0,0,4.4054137576256345,0,9.826940774917603,cheetah-run,187,ALM
1,12500,25000,25,14.060389097029883,12500,206.63682508468628,cheetah-run,187,ALM
2,25000,50000,50,92.43379205564607,25000,412.72728276252747,cheetah-run,187,ALM
3,37500,75000,75,214.07079273347136,37500,619.3207647800446,cheetah-run,187,ALM
4,50000,100000,100,207.35760558415024,50000,825.6597714424133,cheetah-run,187,ALM
5,62500,125000,125,231.76747840307416,62500,1046.0330729484558,cheetah-run,187,ALM
6,75000,150000,150,252.42955137378527,75000,1294.7099187374115,cheetah-run,187,ALM
7,87500,175000,175,276.0730855650263,87500,1548.2936007976532,cheetah-run,187,ALM
8,100000,200000,200,265.8506805578503,100000,1798.8641381263733,cheetah-run,187,ALM
9,112500,225000,225,258.3507251516035,112500,2005.2500236034393,cheetah-run,187,ALM
10,125000,250000,250,203.94497550914485,125000,2212.126606941223,cheetah-run,187,ALM
11,137500,275000,275,181.95049850154084,137500,2418.4005370140076,cheetah-run,187,ALM
12,150000,300000,300,250.41151886824537,150000,2624.8117668628693,cheetah-run,187,ALM
13,162500,325000,325,240.34231258922972,162500,2829.9845967292786,cheetah-run,187,ALM
14,175000,350000,350,249.38625996305095,175000,3034.3086268901825,cheetah-run,187,ALM
15,187500,375000,375,266.77834761932627,187500,3238.8427102565765,cheetah-run,187,ALM
16,200000,400000,400,251.64153831661088,200000,3443.432949781418,cheetah-run,187,ALM
17,212500,425000,425,296.2706282639874,212500,3648.228141307831,cheetah-run,187,ALM
18,225000,450000,450,323.10288694818155,225000,3881.5728986263275,cheetah-run,187,ALM
19,237500,475000,475,313.268953837477,237500,4108.0551834106445,cheetah-run,187,ALM
20,250000,500000,500,338.3818192229518,250000,4326.00084733963,cheetah-run,187,ALM
21,262500,525000,525,355.2765196724847,262500,4540.3873970508575,cheetah-run,187,ALM
22,275000,550000,550,340.14463510109573,275000,4755.0372042655945,cheetah-run,187,ALM
23,287500,575000,575,339.1741334226211,287500,4993.065329551697,cheetah-run,187,ALM
24,300000,600000,600,352.9539010530707,300000,5241.771388530731,cheetah-run,187,ALM
25,312500,625000,625,370.7534713779841,312500,5481.343775510788,cheetah-run,187,ALM
26,325000,650000,650,349.520368245992,325000,5729.517248630524,cheetah-run,187,ALM
27,337500,675000,675,350.5013564803426,337500,5974.66614985466,cheetah-run,187,ALM
28,350000,700000,700,334.49531818367893,350000,6224.485489606857,cheetah-run,187,ALM
29,362500,725000,725,318.578010850813,362500,6474.300563335419,cheetah-run,187,ALM
30,375000,750000,750,287.52246911054044,375000,6724.106805324554,cheetah-run,187,ALM
31,387500,775000,775,331.19005274651965,387500,6951.656945466995,cheetah-run,187,ALM
32,400000,800000,800,329.08288564016095,400000,7156.025790214539,cheetah-run,187,ALM
33,412500,825000,825,342.48195860150247,412500,7386.019769906998,cheetah-run,187,ALM
34,425000,850000,850,347.20249591881947,425000,7627.135920524597,cheetah-run,187,ALM
35,437500,875000,875,368.7747001462762,437500,7853.151056051254,cheetah-run,187,ALM
36,450000,900000,900,357.18380045748137,450000,8061.531288385391,cheetah-run,187,ALM
37,462500,925000,925,360.2781230575028,462500,8277.180176496506,cheetah-run,187,ALM
38,475000,950000,950,370.42221591291127,475000,8490.614923238754,cheetah-run,187,ALM
39,487500,975000,975,375.1914852871535,487500,8703.010246753693,cheetah-run,187,ALM
0,0,0,0,5.05532893039335,0,11.185168027877808,cheetah-run,823,ALM
1,12500,25000,25,23.244147968808207,12500,208.34728264808655,cheetah-run,823,ALM
2,25000,50000,50,87.81187714561754,25000,415.40545868873596,cheetah-run,823,ALM
3,37500,75000,75,199.3389037374057,37500,620.5423452854156,cheetah-run,823,ALM
4,50000,100000,100,233.1879603273209,50000,825.9944999217987,cheetah-run,823,ALM
5,62500,125000,125,260.13493640115655,62500,1032.3266146183014,cheetah-run,823,ALM
6,75000,150000,150,240.7701637982837,75000,1238.8591284751892,cheetah-run,823,ALM
7,87500,175000,175,274.41476273542384,87500,1444.6965699195862,cheetah-run,823,ALM
8,100000,200000,200,311.15668752230226,100000,1650.8695175647736,cheetah-run,823,ALM
9,112500,225000,225,314.5304548630497,112500,1857.1338031291962,cheetah-run,823,ALM
10,125000,250000,250,340.87003389728125,125000,2064.1303403377533,cheetah-run,823,ALM
11,137500,275000,275,337.85823845458947,137500,2273.0946068763733,cheetah-run,823,ALM
12,150000,300000,300,332.08910909727757,150000,2481.1363747119904,cheetah-run,823,ALM
13,162500,325000,325,353.7739471033715,162500,2690.1258113384247,cheetah-run,823,ALM
14,175000,350000,350,351.73929608025145,175000,2899.944871902466,cheetah-run,823,ALM
15,187500,375000,375,349.0430977354004,187500,3110.1554479599,cheetah-run,823,ALM
16,200000,400000,400,372.6031015347136,200000,3318.277264356613,cheetah-run,823,ALM
17,212500,425000,425,313.46548273801875,212500,3525.1211557388306,cheetah-run,823,ALM
18,225000,450000,450,379.4110037041436,225000,3740.7499878406525,cheetah-run,823,ALM
19,237500,475000,475,387.3084907288378,237500,3962.6691789627075,cheetah-run,823,ALM
20,250000,500000,500,393.02357035119394,250000,4168.596553564072,cheetah-run,823,ALM
21,262500,525000,525,413.4737409496635,262500,4376.126779556274,cheetah-run,823,ALM
22,275000,550000,550,399.5973876150861,275000,4581.2871725559235,cheetah-run,823,ALM
23,287500,575000,575,408.040909110726,287500,4787.76611328125,cheetah-run,823,ALM
24,300000,600000,600,413.37572721708,300000,4996.012986898422,cheetah-run,823,ALM
25,312500,625000,625,407.46338468381566,312500,5204.349725484848,cheetah-run,823,ALM
26,325000,650000,650,404.13058952921847,325000,5411.891156196594,cheetah-run,823,ALM
27,337500,675000,675,409.54217900482917,337500,5617.742597818375,cheetah-run,823,ALM
28,350000,700000,700,396.13409911619226,350000,5823.017057418823,cheetah-run,823,ALM
29,362500,725000,725,406.09007673167395,362500,6027.116950750351,cheetah-run,823,ALM
30,375000,750000,750,391.40200950559864,375000,6234.029638290405,cheetah-run,823,ALM
31,387500,775000,775,395.45885016508373,387500,6441.463397979736,cheetah-run,823,ALM
32,400000,800000,800,375.72639305090377,400000,6648.88365650177,cheetah-run,823,ALM
33,412500,825000,825,399.64861591899137,412500,6856.52009510994,cheetah-run,823,ALM
34,425000,850000,850,393.48952138377416,425000,7061.492735147476,cheetah-run,823,ALM
35,437500,875000,875,400.37349115749794,437500,7265.374866962433,cheetah-run,823,ALM
36,450000,900000,900,391.413250242101,450000,7469.105348587036,cheetah-run,823,ALM
37,462500,925000,925,398.45762020127114,462500,7673.061825752258,cheetah-run,823,ALM
38,475000,950000,950,402.4475814607037,475000,7883.354245185852,cheetah-run,823,ALM
39,487500,975000,975,399.68494326558755,487500,8089.358348608017,cheetah-run,823,ALM
0,0,0,0,4.340673161820712,0,13.728291273117065,cheetah-run,832,ALM
1,12500,25000,25,35.8680639326406,12500,220.5578212738037,cheetah-run,832,ALM
2,25000,50000,50,115.45495919087236,25000,439.2738001346588,cheetah-run,832,ALM
3,37500,75000,75,113.91503233232588,37500,657.804571390152,cheetah-run,832,ALM
4,50000,100000,100,162.37681612437763,50000,879.5771706104279,cheetah-run,832,ALM
5,62500,125000,125,198.37562718552945,62500,1098.753488779068,cheetah-run,832,ALM
6,75000,150000,150,246.8776276161214,75000,1316.1864292621613,cheetah-run,832,ALM
7,87500,175000,175,229.19710092756674,87500,1536.2903456687927,cheetah-run,832,ALM
8,100000,200000,200,248.51719332963006,100000,1753.352674484253,cheetah-run,832,ALM
9,112500,225000,225,251.97668118418892,112500,1971.2355008125305,cheetah-run,832,ALM
10,125000,250000,250,245.79943285930025,125000,2187.0055043697357,cheetah-run,832,ALM
11,137500,275000,275,244.9091214997176,137500,2403.2450873851776,cheetah-run,832,ALM
12,150000,300000,300,249.5434433616304,150000,2619.0579557418823,cheetah-run,832,ALM
13,162500,325000,325,259.46361391556843,162500,2841.7048819065094,cheetah-run,832,ALM
14,175000,350000,350,253.1561838925696,175000,3059.9770605564117,cheetah-run,832,ALM
15,187500,375000,375,253.74566301558076,187500,3278.780532360077,cheetah-run,832,ALM
16,200000,400000,400,249.96490700916897,200000,3497.407351255417,cheetah-run,832,ALM
17,212500,425000,425,260.3556608501245,212500,3716.1786267757416,cheetah-run,832,ALM
18,225000,450000,450,262.5728915983991,225000,3943.1618192195892,cheetah-run,832,ALM
19,237500,475000,475,249.2397742671642,237500,4160.735201835632,cheetah-run,832,ALM
20,250000,500000,500,251.8737907156295,250000,4376.834197044373,cheetah-run,832,ALM
21,262500,525000,525,262.2650146050786,262500,4595.524173736572,cheetah-run,832,ALM
22,275000,550000,550,272.9582221914495,275000,4814.5268201828,cheetah-run,832,ALM
23,287500,575000,575,260.56169293691875,287500,5032.954116821289,cheetah-run,832,ALM
24,300000,600000,600,247.85211081576034,300000,5249.58238530159,cheetah-run,832,ALM
25,312500,625000,625,231.42962600400992,312500,5468.074978351593,cheetah-run,832,ALM
26,325000,650000,650,268.7509331423813,325000,5688.058187007904,cheetah-run,832,ALM
27,337500,675000,675,277.25953580577095,337500,5907.751978635788,cheetah-run,832,ALM
28,350000,700000,700,273.25402038394986,350000,6125.967539548874,cheetah-run,832,ALM
29,362500,725000,725,286.8918544524242,362500,6346.286107301712,cheetah-run,832,ALM
30,375000,750000,750,282.61646409006687,375000,6564.0364027023315,cheetah-run,832,ALM
31,387500,775000,775,265.52670227973397,387500,6783.405949115753,cheetah-run,832,ALM
32,400000,800000,800,288.42843242684086,400000,6999.153653860092,cheetah-run,832,ALM
33,412500,825000,825,288.862068898074,412500,7215.662105083466,cheetah-run,832,ALM
34,425000,850000,850,298.59342938739803,425000,7430.68012881279,cheetah-run,832,ALM
35,437500,875000,875,282.3955246517438,437500,7647.111290931702,cheetah-run,832,ALM
36,450000,900000,900,289.22037183661985,450000,7865.896013736725,cheetah-run,832,ALM
37,462500,925000,925,271.7711158080419,462500,8080.460895061493,cheetah-run,832,ALM
38,475000,950000,950,271.28772252367077,475000,8295.054202795029,cheetah-run,832,ALM
39,487500,975000,975,266.674275154185,487500,8509.822366476059,cheetah-run,832,ALM
0,0,0,0,3.807582069828409,0,9.530196189880371,cheetah-run,623,ALM
1,12500,25000,25,17.829632081818094,12500,219.829443693161,cheetah-run,623,ALM
2,25000,50000,50,140.0151551530603,25000,440.5022346973419,cheetah-run,623,ALM
3,37500,75000,75,137.3323813917011,37500,660.3697447776794,cheetah-run,623,ALM
4,50000,100000,100,230.66861816031854,50000,880.2120559215546,cheetah-run,623,ALM
5,62500,125000,125,224.84025840152344,62500,1100.3175258636475,cheetah-run,623,ALM
6,75000,150000,150,253.52702367441663,75000,1321.8124458789825,cheetah-run,623,ALM
7,87500,175000,175,251.79398444271743,87500,1542.232770204544,cheetah-run,623,ALM
8,100000,200000,200,266.89505792117524,100000,1763.4562702178955,cheetah-run,623,ALM
9,112500,225000,225,255.38294760353955,112500,1985.3957500457764,cheetah-run,623,ALM
10,125000,250000,250,275.23634713019635,125000,2206.777547121048,cheetah-run,623,ALM
11,137500,275000,275,280.3674115778141,137500,2427.21839261055,cheetah-run,623,ALM
12,150000,300000,300,308.9966424552792,150000,2650.4433834552765,cheetah-run,623,ALM
13,162500,325000,325,306.46522113344247,162500,2874.6200997829437,cheetah-run,623,ALM
14,175000,350000,350,331.3200132195119,175000,3101.623543024063,cheetah-run,623,ALM
15,187500,375000,375,338.6240437611585,187500,3330.2406842708588,cheetah-run,623,ALM
16,200000,400000,400,342.9375550015493,200000,3557.616087436676,cheetah-run,623,ALM
17,212500,425000,425,354.55190419414544,212500,3785.0149471759796,cheetah-run,623,ALM
18,225000,450000,450,343.7605285914743,225000,4016.751535654068,cheetah-run,623,ALM
19,237500,475000,475,353.88436540201286,237500,4245.069485425949,cheetah-run,623,ALM
20,250000,500000,500,386.0694672647578,250000,4473.919802188873,cheetah-run,623,ALM
21,262500,525000,525,389.61806555008246,262500,4702.442481279373,cheetah-run,623,ALM
22,275000,550000,550,388.1387664544238,275000,4931.02387547493,cheetah-run,623,ALM
23,287500,575000,575,377.86793043155865,287500,5159.211496114731,cheetah-run,623,ALM
24,300000,600000,600,374.67250514687356,300000,5385.736312627792,cheetah-run,623,ALM
25,312500,625000,625,395.9608776409524,312500,5612.434770584106,cheetah-run,623,ALM
26,325000,650000,650,389.4432532440348,325000,5839.055464267731,cheetah-run,623,ALM
27,337500,675000,675,377.66052143111324,337500,6065.716940164566,cheetah-run,623,ALM
28,350000,700000,700,397.308917721051,350000,6292.165948629379,cheetah-run,623,ALM
29,362500,725000,725,394.03680043980756,362500,6518.53141784668,cheetah-run,623,ALM
30,375000,750000,750,374.68845771467153,375000,6745.03253030777,cheetah-run,623,ALM
31,387500,775000,775,393.1220146888705,387500,6970.168404579163,cheetah-run,623,ALM
32,400000,800000,800,392.92890798244105,400000,7195.26474571228,cheetah-run,623,ALM
33,412500,825000,825,354.7227442582747,412500,7414.039451122284,cheetah-run,623,ALM
34,425000,850000,850,295.9673524049864,425000,7632.573487281799,cheetah-run,623,ALM
35,437500,875000,875,335.36181284152406,437500,7854.054287910461,cheetah-run,623,ALM
36,450000,900000,900,9.721881979975414,450000,8073.42400765419,cheetah-run,623,ALM
37,462500,925000,925,21.67669418758686,462500,8293.148252010345,cheetah-run,623,ALM
38,475000,950000,950,377.55465472924254,475000,8511.593345165253,cheetah-run,623,ALM
39,487500,975000,975,393.62898537877726,487500,8729.753037929535,cheetah-run,623,ALM
0,0,0,0,5.9145282454040276,0,11.253094673156738,cheetah-run,589,ALM
1,12500,25000,25,10.594999087043075,12500,233.49977564811707,cheetah-run,589,ALM
2,25000,50000,50,87.80928574261338,25000,463.41402769088745,cheetah-run,589,ALM
3,37500,75000,75,143.37959670192956,37500,698.4877798557281,cheetah-run,589,ALM
4,50000,100000,100,174.34484492568578,50000,920.1371550559998,cheetah-run,589,ALM
5,62500,125000,125,206.2110208007767,62500,1159.8345391750336,cheetah-run,589,ALM
6,75000,150000,150,219.74612313558,75000,1397.7942688465118,cheetah-run,589,ALM
7,87500,175000,175,207.27895337962644,87500,1637.3165612220764,cheetah-run,589,ALM
8,100000,200000,200,223.10933139918833,100000,1885.5234122276306,cheetah-run,589,ALM
9,112500,225000,225,238.80107680548645,112500,2135.17853307724,cheetah-run,589,ALM
10,125000,250000,250,234.80037921317222,125000,2380.8125665187836,cheetah-run,589,ALM
11,137500,275000,275,238.56313499949596,137500,2621.5632729530334,cheetah-run,589,ALM
12,150000,300000,300,241.05744575996837,150000,2888.1575701236725,cheetah-run,589,ALM
13,162500,325000,325,205.53637377847127,162500,3130.168842792511,cheetah-run,589,ALM
14,175000,350000,350,236.5750971042567,175000,3349.404217481613,cheetah-run,589,ALM
15,187500,375000,375,235.53673686380176,187500,3567.736904859543,cheetah-run,589,ALM
16,200000,400000,400,283.7764266907234,200000,3786.8775975704193,cheetah-run,589,ALM
17,212500,425000,425,291.61025689878477,212500,4028.7002425193787,cheetah-run,589,ALM
18,225000,450000,450,295.07651814935275,225000,4255.3595678806305,cheetah-run,589,ALM
19,237500,475000,475,299.14735622425076,237500,4482.735225915909,cheetah-run,589,ALM
20,250000,500000,500,262.0563644806411,250000,4720.453004837036,cheetah-run,589,ALM
21,262500,525000,525,310.0241001200717,262500,4994.995835542679,cheetah-run,589,ALM
22,275000,550000,550,294.079675956609,275000,5269.383696556091,cheetah-run,589,ALM
23,287500,575000,575,298.1953661302534,287500,5543.275110006332,cheetah-run,589,ALM
24,300000,600000,600,327.4829373602999,300000,5806.5590879917145,cheetah-run,589,ALM
25,312500,625000,625,332.74608523606804,312500,6038.760963201523,cheetah-run,589,ALM
26,325000,650000,650,316.5674707720188,325000,6298.515057086945,cheetah-run,589,ALM
27,337500,675000,675,290.5982030235779,337500,6552.955342769623,cheetah-run,589,ALM
28,350000,700000,700,324.30854360323826,350000,6782.477025747299,cheetah-run,589,ALM
29,362500,725000,725,329.7992560214804,362500,7052.633850574493,cheetah-run,589,ALM
30,375000,750000,750,324.51357274103356,375000,7328.054642677307,cheetah-run,589,ALM
31,387500,775000,775,320.4610874057807,387500,7602.739472866058,cheetah-run,589,ALM
32,400000,800000,800,324.6012966394137,400000,7855.320331573486,cheetah-run,589,ALM
33,412500,825000,825,319.7118632918264,412500,8111.887615442276,cheetah-run,589,ALM
34,425000,850000,850,343.91948282781925,425000,8339.52993774414,cheetah-run,589,ALM
35,437500,875000,875,310.1876006833932,437500,8564.637113571167,cheetah-run,589,ALM
36,450000,900000,900,309.20699718472434,450000,8828.78062582016,cheetah-run,589,ALM
37,462500,925000,925,237.15827675163,462500,9086.686992168427,cheetah-run,589,ALM
38,475000,950000,950,307.4741064801205,475000,9344.77018237114,cheetah-run,589,ALM
39,487500,975000,975,297.55600096341016,487500,9586.163251399994,cheetah-run,589,ALM
